DDD 11
ALUMINIO	SP
ARACARIGUAMA	SP
ARUJA	SP
ATIBAIA	SP
BARUERI	SP
BIRITIBA-MIRIM	SP
BOM JESUS DOS PERDOES	SP
BRAGANCA PAULISTA	SP
CABREUVA	SP
CAIEIRAS	SP
CAJAMAR	SP
CAMPO LIMPO PAULISTA	SP
CARAPICUIBA	SP
CIABYTE	SP
COTIA	SP
DIADEMA	SP
EMBU	SP
EMBU-GUACU	SP
FERRAZ DE VASCONCELOS	SP
FRANCISCO MORATO	SP
FRANCO DA ROCHA	SP
GUARAREMA	SP
GUARULHOS	SP
IGARATA	SP
ITAPECERICA DA SERRA	SP
ITAPEVI	SP
ITAQUAQUECETUBA	SP
ITATIBA	SP
ITU	SP
ITUPEVA	SP
JANDIRA	SP
JARINU	SP
JOANOPOLIS	SP
JUNDIAI	SP
JUQUITIBA	SP
MAIRINQUE	SP
MAIRIPORA	SP
MAUA	SP
MOJI DAS CRUZES	SP
MORUNGABA	SP
NAZARE PAULISTA	SP
OSASCO	SP
PEDRA BELA	SP
PINHALZINHO	SP
PIRACAIA	SP
PIRAPORA DO BOM JESUS	SP
POA	SP
RIBEIRAO PIRES	SP
RIO GRANDE DA SERRA	SP
SALESOPOLIS	SP
SALTO	SP
SANTA ISABEL	SP
SANTANA DE PARNAIBA	SP
SANTO ANDRE	SP
SAO BERNARDO DO CAMPO	SP
SAO CAETANO DO SUL	SP
SAO LOURENCO DA SERRA	SP
SAO PAULO	SP
SAO ROQUE	SP
SUZANO	SP
TABOAO DA SERRA	SP
TUIUTI	SP
VARGEM	SP
VARGEM GRANDE PAULISTA	SP
VARZEA PAULISTA	SP
DDD 12
ALUMINIO	SP
ARACARIGUAMA	SP
ARUJA	SP
ATIBAIA	SP
BARUERI	SP
BIRITIBA-MIRIM	SP
BOM JESUS DOS PERDOES	SP
BRAGANCA PAULISTA	SP
CABREUVA	SP
CAIEIRAS	SP
CAJAMAR	SP
CAMPO LIMPO PAULISTA	SP
CARAPICUIBA	SP
CIABYTE	SP
COTIA	SP
DIADEMA	SP
EMBU	SP
EMBU-GUACU	SP
FERRAZ DE VASCONCELOS	SP
FRANCISCO MORATO	SP
FRANCO DA ROCHA	SP
GUARAREMA	SP
GUARULHOS	SP
IGARATA	SP
ITAPECERICA DA SERRA	SP
ITAPEVI	SP
ITAQUAQUECETUBA	SP
ITATIBA	SP
ITU	SP
ITUPEVA	SP
JANDIRA	SP
JARINU	SP
JOANOPOLIS	SP
JUNDIAI	SP
JUQUITIBA	SP
MAIRINQUE	SP
MAIRIPORA	SP
MAUA	SP
MOJI DAS CRUZES	SP
MORUNGABA	SP
NAZARE PAULISTA	SP
OSASCO	SP
PEDRA BELA	SP
PINHALZINHO	SP
PIRACAIA	SP
PIRAPORA DO BOM JESUS	SP
POA	SP
RIBEIRAO PIRES	SP
RIO GRANDE DA SERRA	SP
SALESOPOLIS	SP
SALTO	SP
SANTA ISABEL	SP
SANTANA DE PARNAIBA	SP
SANTO ANDRE	SP
SAO BERNARDO DO CAMPO	SP
SAO CAETANO DO SUL	SP
SAO LOURENCO DA SERRA	SP
SAO PAULO	SP
SAO ROQUE	SP
SUZANO	SP
TABOAO DA SERRA	SP
TUIUTI	SP
VARGEM	SP
VARGEM GRANDE PAULISTA	SP
VARZEA PAULISTA	SP
DDD 13
BERTIOGA	SP
CAJATI	SP
CANANEIA	SP
CUBATAO	SP
ELDORADO	SP
GUARUJA	SP
IGUAPE	SP
ILHA COMPRIDA	SP
ITANHAEM	SP
ITARIRI	SP
JACUPIRANGA	SP
JUQUIA	SP
MIRACATU	SP
MONGAGUA	SP
PARIQUERA-ACU	SP
PEDRO DE TOLEDO	SP
PERUIBE	SP
PRAIA GRANDE	SP
REGISTRO	SP
SANTOS	SP
SAO VICENTE	SP
SETE BARRAS	SP
DDD 14
AGUAS DE SANTA BARBARA	SP
AGUDOS	SP
ALVARO DE CARVALHO	SP
ALVINLANDIA	SP
ANHEMBI	SP
ARANDU	SP
ARCO-IRIS	SP
AREALVA	SP
AREIOPOLIS	SP
AVAI	SP
AVARE	SP
BALBINOS	SP
BARIRI	SP
BARRA BONITA	SP
BASTOS	SP
BAURU	SP
BERNARDINO DE CAMPOS	SP
BOCAINA	SP
BOFETE	SP
BORACEIA	SP
BOREBI	SP
BOTUCATU	SP
BROTAS	SP
CABRALIA PAULISTA	SP
CAFELANDIA	SP
CAMPOS NOVOS PAULISTA	SP
CANITAR	SP
CERQUEIRA CESAR	SP
CHAVANTES	SP
CONCHAS	SP
CORONEL MACEDO	SP
DOIS CORREGOS	SP
DUARTINA	SP
ESPIRITO SANTO DO TURVO	SP
FARTURA	SP
FERNAO	SP
GALIA	SP
GARCA	SP
GETULINA	SP
GUAICARA	SP
GUAIMBE	SP
GUARANTA	SP
HERCULANDIA	SP
IACANGA	SP
IACRI	SP
IARAS	SP
IBIRAREMA	SP
IGARACU DO TIETE	SP
IPAUSSU	SP
ITAI	SP
ITAJU	SP
ITAPUI	SP
ITATINGA	SP
JAU	SP
JULIO MESQUITA	SP
LENCOIS PAULISTA	SP
LINS	SP
LUCIANOPOLIS	SP
LUPERCIO	SP
MACATUBA	SP
MANDURI	SP
MARILIA	SP
MINEIROS DO TIETE	SP
OCAUCU	SP
OLEO	SP
ORIENTE	SP
OSCAR BRESSANE	SP
OURINHOS	SP
PARANAPANEMA	SP
PARDINHO	SP
PAULISTANIA	SP
PEDERNEIRAS	SP
PEREIRAS	SP
PIRAJU	SP
PIRAJUI	SP
PIRATININGA	SP
POMPEIA	SP
PONGAI	SP
PRATANIA	SP
PRESIDENTE ALVES	SP
PROMISSAO	SP
QUEIROZ	SP
QUINTANA	SP
REGINOPOLIS	SP
RIBEIRAO DO SUL	SP
SABINO	SP
SALTO GRANDE	SP
SANTA CRUZ DO RIO PARDO	SP
SAO MANUEL	SP
SAO PEDRO DO TURVO	SP
SARUTAIA	SP
TAGUAI	SP
TAQUARITUBA	SP
TEJUPA	SP
TIMBURI	SP
TORRINHA	SP
TUPA	SP
UBIRAJARA	SP
URU	SP
VERA CRUZ	SP
DDD 15
ALAMBARI	SP
ANGATUBA	SP
APIAI	SP
ARACOIABA DA SERRA	SP
BARAO DE ANTONINA	SP
BARRA DO CHAPEU	SP
BARRA DO TURVO	SP
BOITUVA	SP
BOM SUCESSO DE ITARARE	SP
BURI	SP
CAMPINA DO MONTE ALEGRE	SP
CAPAO BONITO	SP
CAPELA DO ALTO	SP
CERQUILHO	SP
CESARIO LANGE	SP
GUAPIARA	SP
GUAREI	SP
IBIUNA	SP
IPERO	SP
IPORANGA	SP
ITABERA	SP
ITAOCA	SP
ITAPETININGA	SP
ITAPEVA	SP
ITAPIRAPUA PAULISTA	SP
ITAPORANGA	SP
ITARARE	SP
JUMIRIM	SP
LARANJAL PAULISTA	SP
NOVA CAMPINA	SP
PIEDADE	SP
PILAR DO SUL	SP
PORANGABA	SP
PORTO FELIZ	SP
QUADRA	SP
RIBEIRA	SP
RIBEIRAO BRANCO	SP
RIBEIRAO GRANDE	SP
RIVERSUL	SP
SALTO DE PIRAPORA	SP
SAO MIGUEL ARCANJO	SP
SARAPUI	SP
SOROCABA	SP
TAPIRAI	SP
TAQUARIVAI	SP
TATUI	SP
TIETE	SP
TORRE DE PEDRA	SP
VOTORANTIM	SP
DDD 16
ALTINOPOLIS	SP
AMERICO BRASILIENSE	SP
ARAMINA	SP
ARARAQUARA	SP
BARRINHA	SP
BATATAIS	SP
BOA ESPERANCA DO SUL	SP
BORBOREMA	SP
BRODOWSKI	SP
BURITIZAL	SP
CAJURU	SP
CANDIDO RODRIGUES	SP
CASSIA DOS COQUEIROS	SP
CRAVINHOS	SP
CRISTAIS PAULISTA	SP
DOBRADA	SP
DOURADO	SP
DUMONT	SP
FERNANDO PRESTES	SP
FRANCA	SP
GAVIAO PEIXOTO	SP
GUARA	SP
GUARIBA	SP
GUATAPARA	SP
IBATE	SP
IBITINGA	SP
IGARAPAVA	SP
IPUA	SP
ITAPOLIS	SP
ITIRAPUA	SP
ITUVERAVA	SP
JABOTICABAL	SP
JARDINOPOLIS	SP
JERIQUARA	SP
LUIS ANTONIO	SP
MATAO	SP
MIGUELOPOLIS	SP
MONTE ALTO	SP
MORRO AGUDO	SP
MOTUCA	SP
NOVA EUROPA	SP
NUPORANGA	SP
ORLANDIA	SP
PATROCINIO PAULISTA	SP
PEDREGULHO	SP
PITANGUEIRAS	SP
PONTAL	SP
PRADOPOLIS	SP
RESTINGA	SP
RIBEIRAO BONITO	SP
RIBEIRAO CORRENTE	SP
RIBEIRAO PRETO	SP
RIFAINA	SP
RINCAO	SP
SALES OLIVEIRA	SP
SANTA CRUZ DA ESPERANCA	SP
SANTA ERNESTINA	SP
SANTA LUCIA	SP
SANTA ROSA DE VITERBO	SP
SANTO ANTONIO DA ALEGRIA	SP
SAO CARLOS	SP
SAO JOAQUIM DA BARRA	SP
SAO JOSE DA BELA VISTA	SP
SAO SIMAO	SP
SERRA AZUL	SP
SERRANA	SP
SERTAOZINHO	SP
TABATINGA	SP
TAIACU	SP
TAIUVA	SP
TAQUARAL	SP
TAQUARITINGA	SP
TRABIJU	SP
VISTA ALEGRE DO ALTO	SP
DDD 17
ADOLFO	SP
ALTAIR	SP
ALVARES FLORENCE	SP
AMERICO DE CAMPOS	SP
APARECIDA D'OESTE	SP
ARIRANHA	SP
ASPASIA	SP
AURIFLAMA	SP
BADY BASSITT	SP
BALSAMO	SP
BARRETOS	SP
BEBEDOURO	SP
CAJOBI	SP
CARDOSO	SP
CATANDUVA	SP
CATIGUA	SP
CEDRAL	SP
COLINA	SP
COLOMBIA	SP
COSMORAMA	SP
DIRCE REIS	SP
DOLCINOPOLIS	SP
ELISIARIO	SP
EMBAUBA	SP
ESTRELA D'OESTE	SP
FERNANDOPOLIS	SP
FLOREAL	SP
GASTAO VIDIGAL	SP
GENERAL SALGADO	SP
GUAIRA	SP
GUAPIACU	SP
GUARACI	SP
GUARANI D'OESTE	SP
GUZOLANDIA	SP
IBIRA	SP
ICEM	SP
INDIAPORA	SP
IPIGUA	SP
IRAPUA	SP
ITAJOBI	SP
JABORANDI	SP
JACI	SP
JALES	SP
JOSE BONIFACIO	SP
MACAUBAL	SP
MACEDONIA	SP
MAGDA	SP
MARAPOAMA	SP
MARINOPOLIS	SP
MENDONCA	SP
MERIDIANO	SP
MESOPOLIS	SP
MIRA ESTRELA	SP
MIRASSOL	SP
MIRASSOLANDIA	SP
MONCOES	SP
MONTE APRAZIVEL	SP
MONTE AZUL PAULISTA	SP
NEVES PAULISTA	SP
NHANDEARA	SP
NIPOA	SP
NOVA ALIANCA	SP
NOVA CANAA PAULISTA	SP
NOVA CASTILHO	SP
NOVA GRANADA	SP
NOVA LUZITANIA	SP
NOVAIS	SP
NOVO HORIZONTE	SP
OLIMPIA	SP
ONDA VERDE	SP
ORINDIUVA	SP
OUROESTE	SP
PALESTINA	SP
PALMARES PAULISTA	SP
PALMEIRA D'OESTE	SP
PARAISO	SP
PARANAPUA	SP
PARISI	SP
PAULO DE FARIA	SP
PEDRANOPOLIS	SP
PINDORAMA	SP
PIRANGI	SP
POLONI	SP
PONTALINDA	SP
PONTES GESTAL	SP
POPULINA	SP
POTIRENDABA	SP
RIOLANDIA	SP
RUBINEIA	SP
SALES	SP
SANTA ADELIA	SP
SANTA ALBERTINA	SP
SANTA CLARA D'OESTE	SP
SANTA FE DO SUL	SP
SANTA RITA D'OESTE	SP
SANTA SALETE	SP
SANTANA DA PONTE PENSA	SP
SAO FRANCISCO	SP
SAO JOAO DAS DUAS PONTES	SP
SAO JOAO DE IRACEMA	SP
SAO JOSE DO RIO PRETO	SP
SEBASTIANOPOLIS DO SUL	SP
SEVERINIA	SP
TABAPUA	SP
TANABI	SP
TERRA ROXA	SP
TRES FRONTEIRAS	SP
TURMALINA	SP
UBARANA	SP
UCHOA	SP
UNIAO PAULISTA	SP
URANIA	SP
URUPES	SP
VALENTIM GENTIL	SP
VIRADOURO	SP
VITORIA BRASIL	SP
VOTUPORANGA	SP
DDD 18
ADAMANTINA	SP
ALFREDO MARCONDES	SP
ALTO ALEGRE	SP
ALVARES MACHADO	SP
ANDRADINA	SP
ANHUMAS	SP
ARACATUBA	SP
ASSIS	SP
AVANHANDAVA	SP
BARBOSA	SP
BENTO DE ABREU	SP
BILAC	SP
BIRIGUI	SP
BORA	SP
BRAUNA	SP
BREJO ALEGRE	SP
BURITAMA	SP
CAIABU	SP
CAIUA	SP
CANDIDO MOTA	SP
CASTILHO	SP
CLEMENTINA	SP
COROADOS	SP
CRUZALIA	SP
DRACENA	SP
ECHAPORA	SP
EMILIANOPOLIS	SP
ESTRELA DO NORTE	SP
EUCLIDES DA CUNHA PAULISTA	SP
FLORA RICA	SP
FLORIDA PAULISTA	SP
FLORINIA	SP
GABRIEL MONTEIRO	SP
GLICERIO	SP
GUARACAI	SP
GUARARAPES	SP
IEPE	SP
ILHA SOLTEIRA	SP
INDIANA	SP
INUBIA PAULISTA	SP
IRAPURU	SP
ITAPURA	SP
JOAO RAMALHO	SP
JUNQUEIROPOLIS	SP
LAVINIA	SP
LOURDES	SP
LUCELIA	SP
LUIZIANIA	SP
LUTECIA	SP
MARABA PAULISTA	SP
MARACAI	SP
MARIAPOLIS	SP
MARTINOPOLIS	SP
MIRANDOPOLIS	SP
MIRANTE DO PARANAPANEMA	SP
MONTE CASTELO	SP
MURUTINGA DO SUL	SP
NANTES	SP
NARANDIBA	SP
NOVA GUATAPORANGA	SP
NOVA INDEPENDENCIA	SP
OSVALDO CRUZ	SP
OURO VERDE	SP
PACAEMBU	SP
PALMITAL	SP
PANORAMA	SP
PARAGUACU PAULISTA	SP
PARAPUA	SP
PAULICEIA	SP
PEDRINHAS PAULISTA	SP
PENAPOLIS	SP
PEREIRA BARRETO	SP
PIACATU	SP
PIQUEROBI	SP
PIRAPOZINHO	SP
PLANALTO	SP
PLATINA	SP
PRACINHA	SP
PRESIDENTE BERNARDES	SP
PRESIDENTE EPITACIO	SP
PRESIDENTE PRUDENTE	SP
PRESIDENTE VENCESLAU	SP
QUATA	SP
RANCHARIA	SP
REGENTE FEIJO	SP
RIBEIRAO DOS INDIOS	SP
RINOPOLIS	SP
ROSANA	SP
RUBIACEA	SP
SAGRES	SP
SALMOURAO	SP
SANDOVALINA	SP
SANTA MERCEDES	SP
SANTO ANASTACIO	SP
SANTO ANTONIO DO ARACANGUA	SP
SANTO EXPEDITO	SP
SANTOPOLIS DO AGUAPEI	SP
SAO JOAO DO PAU D'ALHO	SP
SUD MENNUCCI	SP
SUZANAPOLIS	SP
TACIBA	SP
TARABAI	SP
TARUMA	SP
TEODORO SAMPAIO	SP
TUPI PAULISTA	SP
TURIUBA	SP
VALPARAISO	SP
ZACARIAS	SP
DDD 19
AGUAI	SP
AGUAS DA PRATA	SP
AGUAS DE LINDOIA	SP
AGUAS DE SAO PEDRO	SP
AMERICANA	SP
AMPARO	SP
ANALANDIA	SP
ARARAS	SP
ARTUR NOGUEIRA	SP
CACONDE	SP
CAMPINAS	SP
CAPIVARI	SP
CASA BRANCA	SP
CHARQUEADA	SP
CONCHAL	SP
CORDEIROPOLIS	SP
CORUMBATAI	SP
COSMOPOLIS	SP
DESCALVADO	SP
DIVINOLANDIA	SP
ELIAS FAUSTO	SP
ENGENHEIRO COELHO	SP
ESPIRITO SANTO DO PINHAL	SP
ESTIVA GERBI	SP
HOLAMBRA	SP
HORTOLANDIA	SP
INDAIATUBA	SP
IPEUNA	SP
IRACEMAPOLIS	SP
ITAPIRA	SP
ITIRAPINA	SP
ITOBI	SP
JAGUARIUNA	SP
LEME	SP
LIMEIRA	SP
LINDOIA	SP
LOUVEIRA	SP
MOCOCA	SP
MOGI GUACU	SP
MOJI-MIRIM	SP
MOMBUCA	SP
MONTE ALEGRE DO SUL	SP
MONTE MOR	SP
NOVA ODESSA	SP
PAULINIA	SP
PEDREIRA	SP
PIRACICABA	SP
PIRASSUNUNGA	SP
PORTO FERREIRA	SP
RAFARD	SP
RIO CLARO	SP
RIO DAS PEDRAS	SP
SALTINHO	SP
SANTA BARBARA D'OESTE	SP
SANTA CRUZ DA CONCEICAO	SP
SANTA CRUZ DAS PALMEIRAS	SP
SANTA GERTRUDES	SP
SANTA MARIA DA SERRA	SP
SANTA RITA DO PASSA QUATRO	SP
SANTO ANTONIO DE POSSE	SP
SANTO ANTONIO DO JARDIM	SP
SAO JOAO DA BOA VISTA	SP
SAO JOSE DO RIO PARDO	SP
SAO PEDRO	SP
SAO SEBASTIAO DA GRAMA	SP
SERRA NEGRA	SP
SOCORRO	SP
SUMARE	SP
TAMBAU	SP
TAPIRATIBA	SP
VALINHOS	SP
VARGEM GRANDE DO SUL	SP
VINHEDO	SP
DDD 21
BELFORD ROXO	RJ
CACHOEIRAS DE MACACU	RJ
DUQUE DE CAXIAS	RJ
GUAPIMIRIM	RJ
ITABORAI	RJ
ITAGUAI	RJ
JAPERI	RJ
MAGE	RJ
MANGARATIBA	RJ
MARICA	RJ
MESQUITA	RJ
NILOPOLIS	RJ
NITEROI	RJ
NOVA IGUACU	RJ
PARACAMBI	RJ
QUEIMADOS	RJ
RIO BONITO	RJ
RIO DE JANEIRO	RJ
SAO GONCALO	RJ
SAO JOAO DE MERITI	RJ
SEROPEDICA	RJ
TANGUA	RJ
TERESOPOLIS	RJ
DDD 22
APERIBE	RJ
ARARUAMA	RJ
ARMACAO DOS BUZIOS	RJ
ARRAIAL DO CABO	RJ
BOM JARDIM	RJ
BOM JESUS DO ITABAPOANA	RJ
CABO FRIO	RJ
CAMBUCI	RJ
CAMPOS DOS GOYTACAZES	RJ
CANTAGALO	RJ
CARAPEBUS	RJ
CARDOSO MOREIRA	RJ
CARMO	RJ
CASIMIRO DE ABREU	RJ
CONCEICAO DE MACABU	RJ
CORDEIRO	RJ
DUAS BARRAS	RJ
IGUABA GRANDE	RJ
ITALVA	RJ
ITAOCARA	RJ
ITAPERUNA	RJ
LAJE DO MURIAE	RJ
MACAE	RJ
MACUCO	RJ
MIRACEMA	RJ
NATIVIDADE	RJ
NOVA FRIBURGO	RJ
PORCIUNCULA	RJ
QUISSAMA	RJ
RIO DAS OSTRAS	RJ
SANTA MARIA MADALENA	RJ
SANTO ANTONIO DE PADUA	RJ
SAO FIDELIS	RJ
SAO FRANCISCO DE ITABAPOANA	RJ
SAO JOAO DA BARRA	RJ
SAO JOSE DE UBA	RJ
SAO PEDRO DA ALDEIA	RJ
SAO SEBASTIAO DO ALTO	RJ
SAQUAREMA	RJ
SILVA JARDIM	RJ
SUMIDOURO	RJ
TRAJANO DE MORAIS	RJ
VARRE-SAI	RJ
DDD 24
ANGRA DOS REIS	RJ
AREAL	RJ
BARRA DO PIRAI	RJ
BARRA MANSA	RJ
COMENDADOR LEVY GASPARIAN	RJ
ENGENHEIRO PAULO DE FRONTIN	RJ
ITATIAIA	RJ
MENDES	RJ
MIGUEL PEREIRA	RJ
PARAIBA DO SUL	RJ
PARATI	RJ
PATY DO ALFERES	RJ
PETROPOLIS	RJ
PINHEIRAL	RJ
PIRAI	RJ
PORTO REAL	RJ
QUATIS	RJ
RESENDE	RJ
RIO CLARO	RJ
RIO DAS FLORES	RJ
SAO JOSE DO VALE DO RIO PRETO	RJ
SAPUCAIA	RJ
TRES RIOS	RJ
VALENCA	RJ
VASSOURAS	RJ
VOLTA REDONDA	RJ
DDD 27
AFONSO CLAUDIO	ES
AGUA DOCE DO NORTE	ES
AGUIA BRANCA	ES
ALFREDO CHAVES	ES
ALTO RIO NOVO	ES
ARACRUZ	ES
BAIXO GUANDU	ES
BARRA DE SAO FRANCISCO	ES
BOA ESPERANCA	ES
BREJETUBA	ES
CARIACICA	ES
COLATINA	ES
CONCEICAO DA BARRA	ES
DOMINGOS MARTINS	ES
ECOPORANGA	ES
FUNDAO	ES
GOVERNADOR LINDENBERG	ES
GUARAPARI	ES
IBIRACU	ES
ITAGUACU	ES
ITARANA	ES
JAGUARE	ES
JOAO NEIVA	ES
LARANJA DA TERRA	ES
LINHARES	ES
MANTENOPOLIS	ES
MARECHAL FLORIANO	ES
MARILANDIA	ES
MONTANHA	ES
MUCURICI	ES
NOVA VENECIA	ES
PANCAS	ES
PEDRO CANARIO	ES
PINHEIROS	ES
PONTO BELO	ES
RIO BANANAL	ES
SANTA LEOPOLDINA	ES
SANTA MARIA DE JETIBA	ES
SANTA TERESA	ES
SAO DOMINGOS DO NORTE	ES
SAO GABRIEL DA PALHA	ES
SAO MATEUS	ES
SAO ROQUE DO CANAA	ES
SERRA	ES
SOORETAMA	ES
VIANA	ES
VILA PAVAO	ES
VILA VALERIO	ES
VILA VELHA	ES
VITORIA	ES
DDD 28
ALEGRE	ES
ANCHIETA	ES
APIACA	ES
ATILIO VIVACQUA	ES
BOM JESUS DO NORTE	ES
CACHOEIRO DE ITAPEMIRIM	ES
CASTELO	ES
CONCEICAO DO CASTELO	ES
DIVINO DE SAO LOURENCO	ES
DORES DO RIO PRETO	ES
GUACUI	ES
IBATIBA	ES
IBITIRAMA	ES
ICONHA	ES
IRUPI	ES
ITAPEMIRIM	ES
IUNA	ES
JERONIMO MONTEIRO	ES
MARATAIZES	ES
MIMOSO DO SUL	ES
MUNIZ FREIRE	ES
MUQUI	ES
PIUMA	ES
PRESIDENTE KENNEDY	ES
RIO NOVO DO SUL	ES
SAO JOSE DO CALCADO	ES
VARGEM ALTA	ES
VENDA NOVA DO IMIGRANTE	ES
DDD 31
ABRE CAMPO	MG
ACAIACA	MG
ALVINOPOLIS	MG
ALVORADA DE MINAS	MG
AMPARO DO SERRA	MG
ANTONIO DIAS	MG
ARACAI	MG
ARAPONGA	MG
BALDIM	MG
BARAO DE COCAIS	MG
BARRA LONGA	MG
BELA VISTA DE MINAS	MG
BELO HORIZONTE	MG
BELO VALE	MG
BETIM	MG
BOM JESUS DO AMPARO	MG
BONFIM	MG
BRUMADINHO	MG
CACHOEIRA DA PRATA	MG
CAETANOPOLIS	MG
CAETE	MG
CAJURI	MG
CANAA	MG
CAPELA NOVA	MG
CAPIM BRANCO	MG
CAPUTIRA	MG
CARANAIBA	MG
CARMESIA	MG
CASA GRANDE	MG
CATAS ALTAS	MG
CATAS ALTAS DA NORUEGA	MG
CONCEICAO DO MATO DENTRO	MG
CONFINS	MG
CONGONHAS	MG
CONGONHAS DO NORTE	MG
CONSELHEIRO LAFAIETE	MG
CONTAGEM	MG
CORDISBURGO	MG
CORONEL FABRICIANO	MG
CRISTIANO OTONI	MG
CRUCILANDIA	MG
DESTERRO DE ENTRE RIOS	MG
DIOGO DE VASCONCELOS	MG
DIONISIO	MG
DOM JOAQUIM	MG
DOM SILVERIO	MG
ENTRE RIOS DE MINAS	MG
ESMERALDAS	MG
FERROS	MG
FLORESTAL	MG
FORTUNA DE MINAS	MG
FUNILANDIA	MG
GUARACIABA	MG
IBIRITE	MG
IGARAPE	MG
INHAUMA	MG
IPATINGA	MG
ITABIRA	MG
ITABIRITO	MG
ITAMBE DO MATO DENTRO	MG
ITATIAIUCU	MG
ITAVERAVA	MG
JABOTICATUBAS	MG
JAGUARACU	MG
JECEABA	MG
JEQUERI	MG
JEQUITIBA	MG
JOAO MONLEVADE	MG
JUATUBA	MG
LAGOA SANTA	MG
LAMIM	MG
MARIANA	MG
MARIO CAMPOS	MG
MARLIERIA	MG
MATEUS LEME	MG
MATIPO	MG
MATOZINHOS	MG
MOEDA	MG
MORRO DO PILAR	MG
NOVA ERA	MG
NOVA LIMA	MG
NOVA UNIAO	MG
ORATORIOS	MG
OURO BRANCO	MG
OURO PRETO	MG
PARAOPEBA	MG
PASSABEM	MG
PEDRA BONITA	MG
PEDRA DO ANTA	MG
PEDRO LEOPOLDO	MG
PIEDADE DE PONTE NOVA	MG
PIEDADE DOS GERAIS	MG
PIRANGA	MG
PONTE NOVA	MG
PORTO FIRME	MG
PRUDENTE DE MORAIS	MG
QUELUZITO	MG
RAPOSOS	MG
RIBEIRAO DAS NEVES	MG
RIO ACIMA	MG
RIO CASCA	MG
RIO DOCE	MG
RIO ESPERA	MG
RIO MANSO	MG
RIO PIRACICABA	MG
SABARA	MG
SANTA BARBARA	MG
SANTA CRUZ DO ESCALVADO	MG
SANTA LUZIA	MG
SANTA MARGARIDA	MG
SANTA MARIA DE ITABIRA	MG
SANTANA DE PIRAPAMA	MG
SANTANA DO RIACHO	MG
SANTANA DOS MONTES	MG
SANTO ANTONIO DO GRAMA	MG
SANTO ANTONIO DO RIO ABAIXO	MG
SAO BRAS DO SUACUI	MG
SAO DOMINGOS DO PRATA	MG
SAO GONCALO DO RIO ABAIXO	MG
SAO JOAQUIM DE BICAS	MG
SAO JOSE DA LAPA	MG
SAO JOSE DO GOIABAL	MG
SAO MIGUEL DO ANTA	MG
SAO SEBASTIAO DO RIO PRETO	MG
SARZEDO	MG
SEM-PEIXE	MG
SENHORA DE OLIVEIRA	MG
SERICITA	MG
SETE LAGOAS	MG
TAQUARACU DE MINAS	MG
TEIXEIRAS	MG
TIMOTEO	MG
URUCANIA	MG
VESPASIANO	MG
VICOSA	MG
DDD 32
ALEM PARAIBA	MG
ALFREDO VASCONCELOS	MG
ALTO CAPARAO	MG
ALTO RIO DOCE	MG
ANTONIO CARLOS	MG
ANTONIO PRADO DE MINAS	MG
ARACITABA	MG
ARANTINA	MG
ARGIRITA	MG
ASTOLFO DUTRA	MG
BARAO DE MONTE ALTO	MG
BARBACENA	MG
BARROSO	MG
BELMIRO BRAGA	MG
BIAS FORTES	MG
BICAS	MG
BOCAINA DE MINAS	MG
BOM JARDIM DE MINAS	MG
BRAS PIRES	MG
CAIANA	MG
CAPARAO	MG
CARANDAI	MG
CARANGOLA	MG
CATAGUASES	MG
CHACARA	MG
CHIADOR	MG
CIPOTANEA	MG
COIMBRA	MG
CONCEICAO DA BARRA DE MINAS	MG
CORONEL PACHECO	MG
CORONEL XAVIER CHAVES	MG
DESCOBERTO	MG
DESTERRO DO MELO	MG
DIVINESIA	MG
DIVINO	MG
DONA EUSEBIA	MG
DORES DE CAMPOS	MG
DORES DO TURVO	MG
ERVALIA	MG
ESPERA FELIZ	MG
ESTRELA DALVA	MG
EUGENOPOLIS	MG
EWBANK DA CAMARA	MG
FARIA LEMOS	MG
FERVEDOURO	MG
GOIANA	MG
GUARANI	MG
GUARARA	MG
GUIDOVAL	MG
GUIRICEMA	MG
IBERTIOGA	MG
ITAMARATI DE MINAS	MG
JUIZ DE FORA	MG
LAGOA DOURADA	MG
LARANJAL	MG
LEOPOLDINA	MG
LIBERDADE	MG
LIMA DUARTE	MG
MADRE DE DEUS DE MINAS	MG
MAR DE ESPANHA	MG
MARIPA DE MINAS	MG
MATIAS BARBOSA	MG
MERCES	MG
MIRADOURO	MG
MIRAI	MG
MURIAE	MG
OLARIA	MG
OLIVEIRA FORTES	MG
ORIZANIA	MG
PAIVA	MG
PALMA	MG
PASSA-VINTE	MG
PATROCINIO DO MURIAE	MG
PAULA CANDIDO	MG
PEDRA DOURADA	MG
PEDRO TEIXEIRA	MG
PEQUERI	MG
PIAU	MG
PIEDADE DO RIO GRANDE	MG
PIRAPETINGA	MG
PIRAUBA	MG
PRADOS	MG
PRESIDENTE BERNARDES	MG
RECREIO	MG
RESENDE COSTA	MG
RESSAQUINHA	MG
RIO NOVO	MG
RIO POMBA	MG
RIO PRETO	MG
RITAPOLIS	MG
ROCHEDO DE MINAS	MG
RODEIRO	MG
ROSARIO DA LIMEIRA	MG
SANTA BARBARA DO MONTE VERDE	MG
SANTA BARBARA DO TUGURIO	MG
SANTA RITA DE IBITIPOCA	MG
SANTA RITA DE JACUTINGA	MG
SANTANA DE CATAGUASES	MG
SANTANA DO DESERTO	MG
SANTANA DO GARAMBEU	MG
SANTO ANTONIO DO AVENTUREIRO	MG
SANTOS DUMONT	MG
SAO FRANCISCO DO GLORIA	MG
SAO GERALDO	MG
SAO JOAO DEL REI	MG
SAO JOAO NEPOMUCENO	MG
SAO SEBASTIAO DA VARGEM ALEGRE	MG
SAO TIAGO	MG
SENADOR CORTES	MG
SENADOR FIRMINO	MG
SENHORA DOS REMEDIOS	MG
SILVEIRANIA	MG
SIMAO PEREIRA	MG
TABULEIRO	MG
TIRADENTES	MG
TOCANTINS	MG
TOMBOS	MG
UBA	MG
VIEIRAS	MG
VISCONDE DO RIO BRANCO	MG
VOLTA GRANDE	MG
DDD 33
ACUCENA	MG
AGUA BOA	MG
AGUAS FORMOSAS	MG
AGUAS VERMELHAS	MG
AIMORES	MG
ALMENARA	MG
ALPERCATA	MG
ALTO JEQUITIBA	MG
ALVARENGA	MG
ARACUAI	MG
ATALEIA	MG
BANDEIRA	MG
BELO ORIENTE	MG
BERILO	MG
BERTOPOLIS	MG
BOM JESUS DO GALHO	MG
BRAUNAS	MG
BUGRE	MG
CACHOEIRA DE PAJEU	MG
CAMPANARIO	MG
CANTAGALO	MG
CAPELINHA	MG
CAPITAO ANDRADE	MG
CARAI	MG
CARATINGA	MG
CARLOS CHAGAS	MG
CATUJI	MG
CENTRAL DE MINAS	MG
CHALE	MG
CHAPADA DO NORTE	MG
COLUNA	MG
COMERCINHO	MG
CONCEICAO DE IPANEMA	MG
CONSELHEIRO PENA	MG
COROACI	MG
CORONEL MURTA	MG
CORREGO NOVO	MG
CRISOLITA	MG
CUPARAQUE	MG
CURRAL DE DENTRO	MG
DIVINO DAS LARANJEIRAS	MG
DIVINOLANDIA DE MINAS	MG
DIVISA ALEGRE	MG
DIVISOPOLIS	MG
DOM CAVATI	MG
DORES DE GUANHAES	MG
DURANDE	MG
ENGENHEIRO CALDAS	MG
ENTRE FOLHAS	MG
FELISBURGO	MG
FERNANDES TOURINHO	MG
FRANCISCO BADARO	MG
FRANCISCOPOLIS	MG
FREI GASPAR	MG
FREI INOCENCIO	MG
FREI LAGONEGRO	MG
FRONTEIRA DOS VALES	MG
GALILEIA	MG
GOIABEIRA	MG
GONZAGA	MG
GOVERNADOR VALADARES	MG
GUANHAES	MG
IAPU	MG
IMBE DE MINAS	MG
INHAPIM	MG
IPABA	MG
IPANEMA	MG
ITABIRINHA DE MANTENA	MG
ITAIPE	MG
ITAMBACURI	MG
ITANHOMI	MG
ITAOBIM	MG
ITINGA	MG
ITUETA	MG
JACINTO	MG
JAMPRUCA	MG
JENIPAPO DE MINAS	MG
JEQUITINHONHA	MG
JOAIMA	MG
JOANESIA	MG
JORDANIA	MG
JOSE GONCALVES DE MINAS	MG
JOSE RAYDAN	MG
LADAINHA	MG
LAJINHA	MG
LEME DO PRADO	MG
LUISBURGO	MG
MACHACALIS	MG
MALACACHETA	MG
MANHUACU	MG
MANHUMIRIM	MG
MANTENA	MG
MARILAC	MG
MARTINS SOARES	MG
MATA VERDE	MG
MATERLANDIA	MG
MEDINA	MG
MENDES PIMENTEL	MG
MESQUITA	MG
MINAS NOVAS	MG
MONTE FORMOSO	MG
MUTUM	MG
NACIP RAYDAN	MG
NANUQUE	MG
NAQUE	MG
NOVA BELEM	MG
NOVA MODICA	MG
NOVO CRUZEIRO	MG
NOVO ORIENTE DE MINAS	MG
OURO VERDE DE MINAS	MG
PADRE PARAISO	MG
PALMOPOLIS	MG
PAULISTAS	MG
PAVAO	MG
PECANHA	MG
PEDRA AZUL	MG
PERIQUITO	MG
PESCADOR	MG
PIEDADE DE CARATINGA	MG
PINGO-D'AGUA	MG
POCRANE	MG
PONTO DOS VOLANTES	MG
POTE	MG
RAUL SOARES	MG
REDUTO	MG
RESPLENDOR	MG
RIO DO PRADO	MG
RIO VERMELHO	MG
RUBIM	MG
SABINOPOLIS	MG
SALTO DA DIVISA	MG
SANTA BARBARA DO LESTE	MG
SANTA EFIGENIA DE MINAS	MG
SANTA HELENA DE MINAS	MG
SANTA MARIA DO SALTO	MG
SANTA MARIA DO SUACUI	MG
SANTA RITA DE MINAS	MG
SANTA RITA DO ITUETO	MG
SANTANA DO MANHUACU	MG
SANTANA DO PARAISO	MG
SANTO ANTONIO DO ITAMBE	MG
SANTO ANTONIO DO JACINTO	MG
SAO DOMINGOS DAS DORES	MG
SAO FELIX DE MINAS	MG
SAO GERALDO DA PIEDADE	MG
SAO GERALDO DO BAIXIO	MG
SAO JOAO DO MANHUACU	MG
SAO JOAO DO MANTENINHA	MG
SAO JOAO DO ORIENTE	MG
SAO JOAO EVANGELISTA	MG
SAO JOSE DA SAFIRA	MG
SAO JOSE DO DIVINO	MG
SAO JOSE DO JACURI	MG
SAO JOSE DO MANTIMENTO	MG
SAO PEDRO DO SUACUI	MG
SAO PEDRO DOS FERROS	MG
SAO SEBASTIAO DO ANTA	MG
SAO SEBASTIAO DO MARANHAO	MG
SARDOA	MG
SENHORA DO PORTO	MG
SERRA DOS AIMORES	MG
SETUBINHA	MG
SIMONESIA	MG
SOBRALIA	MG
TAPARUBA	MG
TARUMIRIM	MG
TEOFILO OTONI	MG
TUMIRITINGA	MG
UBAPORANGA	MG
UMBURATIBA	MG
VARGEM ALEGRE	MG
VERMELHO NOVO	MG
VIRGEM DA LAPA	MG
VIRGINOPOLIS	MG
VIRGOLANDIA	MG
DDD 34
ABADIA DOS DOURADOS	MG
AGUA COMPRIDA	MG
ARAGUARI	MG
ARAPORA	MG
ARAPUA	MG
ARAXA	MG
CACHOEIRA DOURADA	MG
CAMPINA VERDE	MG
CAMPO FLORIDO	MG
CANAPOLIS	MG
CAPINOPOLIS	MG
CARMO DO PARANAIBA	MG
CARNEIRINHO	MG
CASCALHO RICO	MG
CENTRALINA	MG
CLARAVAL	MG
COMENDADOR GOMES	MG
CONCEICAO DAS ALAGOAS	MG
CONQUISTA	MG
COROMANDEL	MG
CRUZEIRO DA FORTALEZA	MG
DELTA	MG
DOURADOQUARA	MG
ESTRELA DO SUL	MG
FRONTEIRA	MG
FRUTAL	MG
GRUPIARA	MG
GUIMARANIA	MG
GURINHATA	MG
IBIA	MG
INDIANOPOLIS	MG
IPIACU	MG
IRAI DE MINAS	MG
ITAPAGIPE	MG
ITUIUTABA	MG
ITURAMA	MG
LAGAMAR	MG
LAGOA FORMOSA	MG
LAGOA GRANDE	MG
LIMEIRA DO OESTE	MG
MATUTINA	MG
MONTE ALEGRE DE MINAS	MG
MONTE CARMELO	MG
NOVA PONTE	MG
PATOS DE MINAS	MG
PATROCINIO	MG
PEDRINOPOLIS	MG
PERDIZES	MG
PIRAJUBA	MG
PLANURA	MG
PRATA	MG
PRATINHA	MG
PRESIDENTE OLEGARIO	MG
RIO PARANAIBA	MG
ROMARIA	MG
SACRAMENTO	MG
SANTA JULIANA	MG
SANTA ROSA DA SERRA	MG
SANTA VITORIA	MG
SAO FRANCISCO DE SALES	MG
SAO GOTARDO	MG
SERRA DO SALITRE	MG
TAPIRA	MG
TIROS	MG
TUPACIGUARA	MG
UBERABA	MG
UBERLANDIA	MG
UNIAO DE MINAS	MG
VAZANTE	MG
VERISSIMO	MG
DDD 35
AGUANIL	MG
AIURUOCA	MG
ALAGOA	MG
ALBERTINA	MG
ALFENAS	MG
ALPINOPOLIS	MG
ALTEROSA	MG
ANDRADAS	MG
ANDRELANDIA	MG
ARCEBURGO	MG
AREADO	MG
BAEPENDI	MG
BANDEIRA DO SUL	MG
BOA ESPERANCA	MG
BOM JESUS DA PENHA	MG
BOM REPOUSO	MG
BOM SUCESSO	MG
BORDA DA MATA	MG
BOTELHOS	MG
BRASOPOLIS	MG
BUENO BRANDAO	MG
CABO VERDE	MG
CACHOEIRA DE MINAS	MG
CALDAS	MG
CAMANDUCAIA	MG
CAMBUI	MG
CAMBUQUIRA	MG
CAMPANHA	MG
CAMPESTRE	MG
CAMPO BELO	MG
CAMPO DO MEIO	MG
CAMPOS GERAIS	MG
CANA VERDE	MG
CANDEIAS	MG
CAPETINGA	MG
CAREACU	MG
CARMO DA CACHOEIRA	MG
CARMO DE MINAS	MG
CARMO DO RIO CLARO	MG
CARRANCAS	MG
CARVALHOPOLIS	MG
CARVALHOS	MG
CASSIA	MG
CAXAMBU	MG
CONCEICAO DA APARECIDA	MG
CONCEICAO DAS PEDRAS	MG
CONCEICAO DO RIO VERDE	MG
CONCEICAO DOS OUROS	MG
CONGONHAL	MG
CONSOLACAO	MG
COQUEIRAL	MG
CORDISLANDIA	MG
CORREGO DO BOM JESUS	MG
CRISTAIS	MG
CRISTINA	MG
CRUZILIA	MG
DELFIM MOREIRA	MG
DELFINOPOLIS	MG
DIVISA NOVA	MG
DOM VICOSO	MG
ELOI MENDES	MG
ESPIRITO SANTO DO DOURADO	MG
ESTIVA	MG
EXTREMA	MG
FAMA	MG
FORTALEZA DE MINAS	MG
GONCALVES	MG
GUAPE	MG
GUARANESIA	MG
GUAXUPE	MG
HELIODORA	MG
IBIRACI	MG
IBITIURA DE MINAS	MG
IBITURUNA	MG
IJACI	MG
ILICINEA	MG
INCONFIDENTES	MG
INGAI	MG
IPUIUNA	MG
ITAJUBA	MG
ITAMOGI	MG
ITAMONTE	MG
ITANHANDU	MG
ITAPEVA	MG
ITAU DE MINAS	MG
ITUMIRIM	MG
ITUTINGA	MG
JACUI	MG
JACUTINGA	MG
JESUANIA	MG
JURUAIA	MG
LAMBARI	MG
LAVRAS	MG
LUMINARIAS	MG
MACHADO	MG
MARIA DA FE	MG
MARMELOPOLIS	MG
MINDURI	MG
MONSENHOR PAULO	MG
MONTE BELO	MG
MONTE SANTO DE MINAS	MG
MONTE SIAO	MG
MUNHOZ	MG
MUZAMBINHO	MG
NATERCIA	MG
NAZARENO	MG
NEPOMUCENO	MG
NOVA RESENDE	MG
OLIMPIO NORONHA	MG
OURO FINO	MG
PARAGUACU	MG
PARAISOPOLIS	MG
PASSA QUATRO	MG
PASSOS	MG
PEDRALVA	MG
PERDOES	MG
PIRANGUCU	MG
PIRANGUINHO	MG
POCO FUNDO	MG
POCOS DE CALDAS	MG
POUSO ALEGRE	MG
POUSO ALTO	MG
PRATAPOLIS	MG
RIBEIRAO VERMELHO	MG
SANTA RITA DE CALDAS	MG
SANTA RITA DO SAPUCAI	MG
SANTANA DA VARGEM	MG
SANTANA DO JACARE	MG
SANTO ANTONIO DO AMPARO	MG
SAO BENTO ABADE	MG
SAO GONCALO DO SAPUCAI	MG
SAO JOAO BATISTA DO GLORIA	MG
SAO JOAO DA MATA	MG
SAO JOSE DA BARRA	MG
SAO JOSE DO ALEGRE	MG
SAO LOURENCO	MG
SAO PEDRO DA UNIAO	MG
SAO SEBASTIAO DA BELA VISTA	MG
SAO SEBASTIAO DO PARAISO	MG
SAO SEBASTIAO DO RIO VERDE	MG
SAO THOME DAS LETRAS	MG
SAO TOMAS DE AQUINO	MG
SAO VICENTE DE MINAS	MG
SAPUCAI-MIRIM	MG
SENADOR AMARAL	MG
SENADOR JOSE BENTO	MG
SERITINGA	MG
SERRANIA	MG
SERRANOS	MG
SILVIANOPOLIS	MG
SOLEDADE DE MINAS	MG
TOCOS DO MOJI	MG
TOLEDO	MG
TRES CORACOES	MG
TRES PONTAS	MG
TURVOLANDIA	MG
VARGINHA	MG
VIRGINIA	MG
WENCESLAU BRAZ	MG
DDD 37
ABAETE	MG
ARAUJOS	MG
ARCOS	MG
BAMBUI	MG
BIQUINHAS	MG
BOM DESPACHO	MG
CAMACHO	MG
CAMPOS ALTOS	MG
CAPITOLIO	MG
CARMO DA MATA	MG
CARMO DO CAJURU	MG
CARMOPOLIS DE MINAS	MG
CEDRO DO ABAETE	MG
CLAUDIO	MG
CONCEICAO DO PARA	MG
CORREGO DANTA	MG
CORREGO FUNDO	MG
DIVINOPOLIS	MG
DORES DO INDAIA	MG
DORESOPOLIS	MG
ESTRELA DO INDAIA	MG
FORMIGA	MG
IGARATINGA	MG
IGUATAMA	MG
ITAGUARA	MG
ITAPECERICA	MG
ITAUNA	MG
JAPARAIBA	MG
LAGOA DA PRATA	MG
LEANDRO FERREIRA	MG
LUZ	MG
MARAVILHAS	MG
MARTINHO CAMPOS	MG
MEDEIROS	MG
MOEMA	MG
NOVA SERRANA	MG
OLIVEIRA	MG
ONCA DE PITANGUI	MG
PAINEIRAS	MG
PAINS	MG
PAPAGAIOS	MG
PARA DE MINAS	MG
PASSA TEMPO	MG
PEDRA DO INDAIA	MG
PEQUI	MG
PERDIGAO	MG
PIMENTA	MG
PIRACEMA	MG
PITANGUI	MG
PIUMHI	MG
POMPEU	MG
QUARTEL GERAL	MG
SANTO ANTONIO DO MONTE	MG
SAO FRANCISCO DE PAULA	MG
SAO GONCALO DO PARA	MG
SAO JOSE DA VARGINHA	MG
SAO ROQUE DE MINAS	MG
SAO SEBASTIAO DO OESTE	MG
SERRA DA SAUDADE	MG
TAPIRAI	MG
VARGEM BONITA	MG
DDD 38
ARICANDUVA	MG
ARINOS	MG
AUGUSTO DE LIMA	MG
BERIZAL	MG
BOCAIUVA	MG
BONFINOPOLIS DE MINAS	MG
BONITO DE MINAS	MG
BOTUMIRIM	MG
BRASILANDIA DE MINAS	MG
BRASILIA DE MINAS	MG
BUENOPOLIS	MG
BURITIS	MG
BURITIZEIRO	MG
CABECEIRA GRANDE	MG
CAMPO AZUL	MG
CAPITAO ENEAS	MG
CARBONITA	MG
CATUTI	MG
CHAPADA GAUCHA	MG
CLARO DOS POCOES	MG
CONEGO MARINHO	MG
CORACAO DE JESUS	MG
CORINTO	MG
COUTO DE MAGALHAES DE MINAS	MG
CRISTALIA	MG
CURVELO	MG
DATAS	MG
DIAMANTINA	MG
DOM BOSCO	MG
ENGENHEIRO NAVARRO	MG
ESPINOSA	MG
FELICIO DOS SANTOS	MG
FELIXLANDIA	MG
FORMOSO	MG
FRANCISCO DUMONT	MG
FRANCISCO SA	MG
FRUTA DE LEITE	MG
GAMELEIRAS	MG
GLAUCILANDIA	MG
GOUVEIA	MG
GRAO MOGOL	MG
GUARACIAMA	MG
GUARDA-MOR	MG
IBIAI	MG
IBIRACATU	MG
ICARAI DE MINAS	MG
INDAIABIRA	MG
INIMUTABA	MG
ITACAMBIRA	MG
ITACARAMBI	MG
ITAMARANDIBA	MG
JAIBA	MG
JANAUBA	MG
JANUARIA	MG
JAPONVAR	MG
JEQUITAI	MG
JOAO PINHEIRO	MG
JOAQUIM FELICIO	MG
JOSENOPOLIS	MG
JURAMENTO	MG
JUVENILIA	MG
LAGOA DOS PATOS	MG
LASSANCE	MG
LONTRA	MG
LUISLANDIA	MG
MAMONAS	MG
MANGA	MG
MATIAS CARDOSO	MG
MATO VERDE	MG
MIRABELA	MG
MIRAVANIA	MG
MONJOLOS	MG
MONTALVANIA	MG
MONTE AZUL	MG
MONTES CLAROS	MG
MONTEZUMA	MG
MORADA NOVA DE MINAS	MG
MORRO DA GARCA	MG
NATALANDIA	MG
NINHEIRA	MG
NOVA PORTEIRINHA	MG
NOVORIZONTE	MG
OLHOS-D'AGUA	MG
PADRE CARVALHO	MG
PAI PEDRO	MG
PARACATU	MG
PATIS	MG
PEDRAS DE MARIA DA CRUZ	MG
PINTOPOLIS	MG
PIRAPORA	MG
PONTO CHIQUE	MG
PORTEIRINHA	MG
PRESIDENTE JUSCELINO	MG
PRESIDENTE KUBITSCHEK	MG
RIACHINHO	MG
RIACHO DOS MACHADOS	MG
RIO PARDO DE MINAS	MG
RUBELITA	MG
SALINAS	MG
SANTA CRUZ DE SALINAS	MG
SANTA FE DE MINAS	MG
SANTO ANTONIO DO RETIRO	MG
SANTO HIPOLITO	MG
SAO FRANCISCO	MG
SAO GONCALO DO ABAETE	MG
SAO GONCALO DO RIO PRETO	MG
SAO JOAO DA LAGOA	MG
SAO JOAO DA PONTE	MG
SAO JOAO DAS MISSOES	MG
SAO JOAO DO PACUI	MG
SAO JOAO DO PARAISO	MG
SAO ROMAO	MG
SENADOR MODESTINO GONCALVES	MG
SERRA AZUL DE MINAS	MG
SERRANOPOLIS DE MINAS	MG
SERRO	MG
TAIOBEIRAS	MG
TRES MARIAS	MG
TURMALINA	MG
UBAI	MG
UNAI	MG
URUANA DE MINAS	MG
URUCUIA	MG
VARGEM GRANDE DO RIO PARDO	MG
VARJAO DE MINAS	MG
VARZEA DA PALMA	MG
VARZELANDIA	MG
VERDELANDIA	MG
VEREDINHA	MG
DDD 41
ADRIANOPOLIS	PR
AGUDOS DO SUL	PR
ALMIRANTE TAMANDARE	PR
ANTONINA	PR
ARAUCARIA	PR
BALSA NOVA	PR
BOCAIUVA DO SUL	PR
CAMPINA GRANDE DO SUL	PR
CAMPO DO TENENTE	PR
CAMPO LARGO	PR
CAMPO MAGRO	PR
CERRO AZUL	PR
COLOMBO	PR
CONTENDA	PR
CURITIBA	PR
DOUTOR ULYSSES	PR
FAZENDA RIO GRANDE	PR
GUARAQUECABA	PR
GUARATUBA	PR
ITAPERUCU	PR
LAPA	PR
MANDIRITUBA	PR
MATINHOS	PR
MORRETES	PR
PARANAGUA	PR
PIEN	PR
PINHAIS	PR
PIRAQUARA	PR
PONTAL DO PARANA	PR
QUATRO BARRAS	PR
QUITANDINHA	PR
RIO BRANCO DO SUL	PR
RIO NEGRO	PR
SAO JOSE DOS PINHAIS	PR
TIJUCAS DO SUL	PR
TUNAS DO PARANA	PR
DDD 42
ALTAMIRA DO PARANA	PR
ANTONIO OLINTO	PR
BITURUNA	PR
BOA VENTURA DE SAO ROQUE	PR
CAMPINA DO SIMAO	PR
CANDOI	PR
CANTAGALO	PR
CARAMBEI	PR
CASTRO	PR
CRUZ MACHADO	PR
FERNANDES PINHEIRO	PR
FOZ DO JORDAO	PR
GENERAL CARNEIRO	PR
GOIOXIM	PR
GUAMIRANGA	PR
GUARAPUAVA	PR
IMBAU	PR
IMBITUVA	PR
INACIO MARTINS	PR
IPIRANGA	PR
IRATI	PR
IVAI	PR
LARANJAL	PR
LARANJEIRAS DO SUL	PR
MALLET	PR
MARQUINHO	PR
MATO RICO	PR
NOVA LARANJEIRAS	PR
NOVA TEBAS	PR
ORTIGUEIRA	PR
PALMEIRA	PR
PALMITAL	PR
PAULA FREITAS	PR
PAULO FRONTIN	PR
PINHAO	PR
PIRAI DO SUL	PR
PITANGA	PR
PONTA GROSSA	PR
PORTO AMAZONAS	PR
PORTO BARREIRO	PR
PORTO UNIAO	SC
PORTO VITORIA	PR
PRUDENTOPOLIS	PR
REBOUCAS	PR
RESERVA	PR
RESERVA DO IGUACU	PR
RIO AZUL	PR
RIO BONITO DO IGUACU	PR
SANTA MARIA DO OESTE	PR
SAO JOAO DO TRIUNFO	PR
SAO MATEUS DO SUL	PR
TEIXEIRA SOARES	PR
TELEMACO BORBA	PR
TIBAGI	PR
TURVO	PR
UNIAO DA VITORIA	PR
VENTANIA	PR
VIRMOND	PR
DDD 43
ABATIA	PR
ALVORADA DO SUL	PR
ANDIRA	PR
APUCARANA	PR
ARAPONGAS	PR
ARAPOTI	PR
ARAPUA	PR
ARIRANHA DO IVAI	PR
ASSAI	PR
BANDEIRANTES	PR
BARRA DO JACARE	PR
BELA VISTA DO PARAISO	PR
BOM SUCESSO	PR
BORRAZOPOLIS	PR
CAFEARA	PR
CALIFORNIA	PR
CAMBARA	PR
CAMBE	PR
CAMBIRA	PR
CANDIDO DE ABREU	PR
CARLOPOLIS	PR
CENTENARIO DO SUL	PR
CONGONHINHAS	PR
CONSELHEIRO MAIRINCK	PR
CORNELIO PROCOPIO	PR
CRUZMALTINA	PR
CURIUVA	PR
FAXINAL	PR
FIGUEIRA	PR
FLORESTOPOLIS	PR
GODOY MOREIRA	PR
GRANDES RIOS	PR
GUAPIRAMA	PR
GUARACI	PR
IBAITI	PR
IBIPORA	PR
ITAMBARACA	PR
IVAIPORA	PR
JABOTI	PR
JACAREZINHO	PR
JAGUAPITA	PR
JAGUARIAIVA	PR
JANDAIA DO SUL	PR
JAPIRA	PR
JARDIM ALEGRE	PR
JATAIZINHO	PR
JOAQUIM TAVORA	PR
JUNDIAI DO SUL	PR
KALORE	PR
LEOPOLIS	PR
LIDIANOPOLIS	PR
LONDRINA	PR
LUNARDELLI	PR
LUPIONOPOLIS	PR
MANOEL RIBAS	PR
MARILANDIA DO SUL	PR
MARUMBI	PR
MAUA DA SERRA	PR
MIRASELVA	PR
NOVA AMERICA DA COLINA	PR
NOVA FATIMA	PR
NOVA SANTA BARBARA	PR
NOVO ITACOLOMI	PR
PINHALAO	PR
PITANGUEIRAS	PR
PORECATU	PR
PRADO FERREIRA	PR
PRIMEIRO DE MAIO	PR
QUATIGUA	PR
RANCHO ALEGRE	PR
RIBEIRAO CLARO	PR
RIBEIRAO DO PINHAL	PR
RIO BOM	PR
RIO BRANCO DO IVAI	PR
ROLANDIA	PR
ROSARIO DO IVAI	PR
SALTO DO ITARARE	PR
SANTA AMELIA	PR
SANTA CECILIA DO PAVAO	PR
SANTA MARIANA	PR
SANTANA DO ITARARE	PR
SANTO ANTONIO DA PLATINA	PR
SANTO ANTONIO DO PARAISO	PR
SAO JERONIMO DA SERRA	PR
SAO JOAO DO IVAI	PR
SAO JOSE DA BOA VISTA	PR
SAO PEDRO DO IVAI	PR
SAO SEBASTIAO DA AMOREIRA	PR
SAPOPEMA	PR
SENGES	PR
SERTANEJA	PR
SERTANOPOLIS	PR
SIQUEIRA CAMPOS	PR
TAMARANA	PR
TOMAZINA	PR
URAI	PR
WENCESLAU BRAZ	PR
DDD 44
ALTO PARANA	PR
ALTO PIQUIRI	PR
ALTONIA	PR
AMAPORA	PR
ANGULO	PR
ARARUNA	PR
ASSIS CHATEAUBRIAND	PR
ASTORGA	PR
ATALAIA	PR
BARBOSA FERRAZ	PR
BOA ESPERANCA	PR
BRASILANDIA DO SUL	PR
CAFEZAL DO SUL	PR
CAMPINA DA LAGOA	PR
CAMPO MOURAO	PR
CIANORTE	PR
CIDADE GAUCHA	PR
COLORADO	PR
CORUMBATAI DO SUL	PR
CRUZEIRO DO OESTE	PR
CRUZEIRO DO SUL	PR
DIAMANTE DO NORTE	PR
DOURADINA	PR
DOUTOR CAMARGO	PR
ENGENHEIRO BELTRAO	PR
ESPERANCA NOVA	PR
FAROL	PR
FENIX	PR
FLORAI	PR
FLORESTA	PR
FLORIDA	PR
FORMOSA DO OESTE	PR
FRANCISCO ALVES	PR
GOIOERE	PR
GUAIRA	PR
GUAIRACA	PR
GUAPOREMA	PR
ICARAIMA	PR
IGUARACU	PR
INAJA	PR
INDIANOPOLIS	PR
IPORA	PR
IRACEMA DO OESTE	PR
IRETAMA	PR
ITAGUAJE	PR
ITAMBE	PR
ITAUNA DO SUL	PR
IVATE	PR
IVATUBA	PR
JANIOPOLIS	PR
JAPURA	PR
JARDIM OLINDA	PR
JESUITAS	PR
JURANDA	PR
JUSSARA	PR
LOANDA	PR
LOBATO	PR
LUIZIANA	PR
MAMBORE	PR
MANDAGUACU	PR
MANDAGUARI	PR
MARIA HELENA	PR
MARIALVA	PR
MARILENA	PR
MARILUZ	PR
MARINGA	PR
MARIPA	PR
MIRADOR	PR
MOREIRA SALES	PR
MUNHOZ DE MELO	PR
NOSSA SENHORA DAS GRACAS	PR
NOVA ALIANCA DO IVAI	PR
NOVA CANTU	PR
NOVA ESPERANCA	PR
NOVA LONDRINA	PR
NOVA OLIMPIA	PR
OURIZONA	PR
PAICANDU	PR
PALOTINA	PR
PARAISO DO NORTE	PR
PARANACITY	PR
PARANAPOEMA	PR
PARANAVAI	PR
PEABIRU	PR
PEROBAL	PR
PEROLA	PR
PLANALTINA DO PARANA	PR
PORTO RICO	PR
PRESIDENTE CASTELO BRANCO	PR
QUARTO CENTENARIO	PR
QUERENCIA DO NORTE	PR
QUINTA DO SOL	PR
RANCHO ALEGRE D'OESTE	PR
RONCADOR	PR
RONDON	PR
SABAUDIA	PR
SANTA CRUZ DE MONTE CASTELO	PR
SANTA FE	PR
SANTA INES	PR
SANTA ISABEL DO IVAI	PR
SANTA MONICA	PR
SANTO ANTONIO DO CAIUA	PR
SANTO INACIO	PR
SAO CARLOS DO IVAI	PR
SAO JOAO DO CAIUA	PR
SAO JORGE DO IVAI	PR
SAO JORGE DO PATROCINIO	PR
SAO MANOEL DO PARANA	PR
SAO PEDRO DO PARANA	PR
SAO TOME	PR
SARANDI	PR
TAMBOARA	PR
TAPEJARA	PR
TAPIRA	PR
TERRA BOA	PR
TERRA RICA	PR
TERRA ROXA	PR
TUNEIRAS DO OESTE	PR
TUPASSI	PR
UBIRATA	PR
UMUARAMA	PR
UNIFLOR	PR
VILA ALTA	PR
XAMBRE	PR
DDD 45
ANAHY	PR
BOA VISTA DA APARECIDA	PR
BRAGANEY	PR
CAFELANDIA	PR
CAMPO BONITO	PR
CAPITAO LEONIDAS MARQUES	PR
CASCAVEL	PR
CATANDUVAS	PR
CEU AZUL	PR
CORBELIA	PR
DIAMANTE DO SUL	PR
DIAMANTE D'OESTE	PR
ENTRE RIOS DO OESTE	PR
FOZ DO IGUACU	PR
GUARANIACU	PR
IBEMA	PR
IGUATU	PR
ITAIPULANDIA	PR
LINDOESTE	PR
MARECHAL CANDIDO RONDON	PR
MATELANDIA	PR
MEDIANEIRA	PR
MERCEDES	PR
MISSAL	PR
NOVA AURORA	PR
NOVA SANTA ROSA	PR
OURO VERDE DO OESTE	PR
PATO BRAGADO	PR
QUATRO PONTES	PR
RAMILANDIA	PR
SANTA HELENA	PR
SANTA LUCIA	PR
SANTA TEREZA DO OESTE	PR
SANTA TEREZINHA DE ITAIPU	PR
SAO JOSE DAS PALMEIRAS	PR
SAO MIGUEL DO IGUACU	PR
SAO PEDRO DO IGUACU	PR
SERRANOPOLIS DO IGUACU	PR
TOLEDO	PR
TRES BARRAS DO PARANA	PR
VERA CRUZ DO OESTE	PR
DDD 46
AMPERE	PR
BELA VISTA DA CAROBA	PR
BOA ESPERANCA DO IGUACU	PR
BOM JESUS DO SUL	PR
BOM SUCESSO DO SUL	PR
CAPANEMA	PR
CHOPINZINHO	PR
CLEVELANDIA	PR
CORONEL DOMINGOS SOARES	PR
CORONEL VIVIDA	PR
CRUZEIRO DO IGUACU	PR
DOIS VIZINHOS	PR
ENEAS MARQUES	PR
ESPIGAO ALTO DO IGUACU	PR
FLOR DA SERRA DO SUL	PR
FRANCISCO BELTRAO	PR
HONORIO SERPA	PR
ITAPEJARA D'OESTE	PR
MANFRINOPOLIS	PR
MANGUEIRINHA	PR
MARIOPOLIS	PR
MARMELEIRO	PR
NOVA ESPERANCA DO SUDOESTE	PR
NOVA PRATA DO IGUACU	PR
PALMAS	PR
PATO BRANCO	PR
PEROLA D'OESTE	PR
PINHAL DE SAO BENTO	PR
PLANALTO	PR
PRANCHITA	PR
QUEDAS DO IGUACU	PR
REALEZA	PR
RENASCENCA	PR
SALGADO FILHO	PR
SALTO DO LONTRA	PR
SANTA IZABEL DO OESTE	PR
SANTO ANTONIO DO SUDOESTE	PR
SAO JOAO	PR
SAO JORGE D'OESTE	PR
SAUDADE DO IGUACU	PR
SULINA	PR
VERE	PR
VITORINO	PR
DDD 47
AGROLANDIA	SC
AGRONOMICA	SC
APIUNA	SC
ARAQUARI	SC
ASCURRA	SC
ATALANTA	SC
AURORA	SC
BALNEARIO BARRA DO SUL	SC
BALNEARIO CAMBORIU	SC
BARRA VELHA	SC
BELA VISTA DO TOLDO	SC
BENEDITO NOVO	SC
BLUMENAU	SC
BOMBINHAS	SC
BOTUVERA	SC
BRACO DO TROMBUDO	SC
BRUSQUE	SC
CAMBORIU	SC
CAMPO ALEGRE	SC
CANOINHAS	SC
CHAPADAO DO LAGEADO	SC
CORUPA	SC
DONA EMMA	SC
DOUTOR PEDRINHO	SC
GARUVA	SC
GASPAR	SC
GUABIRUBA	SC
GUARAMIRIM	SC
IBIRAMA	SC
ILHOTA	SC
IMBUIA	SC
INDAIAL	SC
IRINEOPOLIS	SC
ITAIOPOLIS	SC
ITAJAI	SC
ITAPEMA	SC
ITAPOA	SC
ITUPORANGA	SC
JARAGUA DO SUL	SC
JOINVILLE	SC
JOSE BOITEUX	SC
LAURENTINO	SC
LONTRAS	SC
LUIZ ALVES	SC
MAFRA	SC
MAJOR VIEIRA	SC
MASSARANDUBA	SC
MIRIM DOCE	SC
MONTE CASTELO	SC
NAVEGANTES	SC
PAPANDUVA	SC
PENHA	SC
PETROLANDIA	SC
PICARRAS	SC
POMERODE	SC
PORTO BELO	SC
POUSO REDONDO	SC
PRESIDENTE GETULIO	SC
PRESIDENTE NEREU	SC
RIO DO CAMPO	SC
RIO DO OESTE	SC
RIO DO SUL	SC
RIO DOS CEDROS	SC
RIO NEGRINHO	SC
RODEIO	SC
SALETE	SC
SANTA TEREZINHA	SC
SAO BENTO DO SUL	SC
SAO FRANCISCO DO SUL	SC
SAO JOAO DO ITAPERIU	SC
SCHROEDER	SC
TAIO	SC
TIMBO	SC
TRES BARRAS	SC
TROMBUDO CENTRAL	SC
VIDAL RAMOS	SC
VITOR MEIRELES	SC
WITMARSUM	SC
DDD 48
AGUAS MORNAS	SC
ALFREDO WAGNER	SC
ANGELINA	SC
ANITAPOLIS	SC
ANTONIO CARLOS	SC
ARARANGUA	SC
ARMAZEM	SC
BALNEARIO ARROIO DO SILVA	SC
BALNEARIO GAIVOTA	SC
BIGUACU	SC
BRACO DO NORTE	SC
CANELINHA	SC
CAPIVARI DE BAIXO	SC
COCAL DO SUL	SC
CRICIUMA	SC
ERMO	SC
FLORIANOPOLIS	SC
FORQUILHINHA	SC
GAROPABA	SC
GOVERNADOR CELSO RAMOS	SC
GRAO PARA	SC
GRAVATAL	SC
ICARA	SC
IMARUI	SC
IMBITUBA	SC
JACINTO MACHADO	SC
JAGUARUNA	SC
LAGUNA	SC
LAURO MULLER	SC
LEOBERTO LEAL	SC
MAJOR GERCINO	SC
MARACAJA	SC
MELEIRO	SC
MORRO DA FUMACA	SC
MORRO GRANDE	SC
NOVA TRENTO	SC
NOVA VENEZA	SC
ORLEANS	SC
PALHOCA	SC
PASSO DE TORRES	SC
PAULO LOPES	SC
PEDRAS GRANDES	SC
PRAIA GRANDE	SC
RANCHO QUEIMADO	SC
RIO FORTUNA	SC
SANGAO	SC
SANTA ROSA DE LIMA	SC
SANTA ROSA DO SUL	SC
SANTO AMARO DA IMPERATRIZ	SC
SAO BONIFACIO	SC
SAO JOAO BATISTA	SC
SAO JOAO DO SUL	SC
SAO JOSE	SC
SAO LUDGERO	SC
SAO MARTINHO	SC
SAO PEDRO DE ALCANTARA	SC
SIDEROPOLIS	SC
SOMBRIO	SC
TIJUCAS	SC
TIMBE DO SUL	SC
TREVISO	SC
TREZE DE MAIO	SC
TUBARAO	SC
TURVO	SC
URUSSANGA	SC
DDD 49
ABDON BATISTA	SC
ABELARDO LUZ	SC
AGUA DOCE	SC
AGUAS DE CHAPECO	SC
AGUAS FRIAS	SC
ALTO BELA VISTA	SC
ANCHIETA	SC
ANITA GARIBALDI	SC
ARABUTA	SC
ARROIO TRINTA	SC
ARVOREDO	SC
BANDEIRANTE	SC
BARRA BONITA	SC
BELMONTE	SC
BOCAINA DO SUL	SC
BOM JARDIM DA SERRA	SC
BOM JESUS	SC
BOM JESUS DO OESTE	SC
BOM RETIRO	SC
BRUNOPOLIS	SC
CACADOR	SC
CAIBI	SC
CALMON	SC
CAMPO BELO DO SUL	SC
CAMPO ERE	SC
CAMPOS NOVOS	SC
CAPAO ALTO	SC
CAPINZAL	SC
CATANDUVAS	SC
CAXAMBU DO SUL	SC
CELSO RAMOS	SC
CERRO NEGRO	SC
CHAPECO	SC
CONCORDIA	SC
CORDILHEIRA ALTA	SC
CORONEL FREITAS	SC
CORONEL MARTINS	SC
CORREIA PINTO	SC
CUNHA PORA	SC
CUNHATAI	SC
CURITIBANOS	SC
DESCANSO	SC
DIONISIO CERQUEIRA	SC
ENTRE RIOS	SC
ERVAL VELHO	SC
FAXINAL DOS GUEDES	SC
FLOR DO SERTAO	SC
FORMOSA DO SUL	SC
FRAIBURGO	SC
FREI ROGERIO	SC
GALVAO	SC
GUARACIABA	SC
GUARUJA DO SUL	SC
GUATAMBU	SC
HERVAL D'OESTE	SC
IBIAM	SC
IBICARE	SC
IOMERE	SC
IPIRA	SC
IPORA DO OESTE	SC
IPUACU	SC
IPUMIRIM	SC
IRACEMINHA	SC
IRANI	SC
IRATI	SC
ITA	SC
ITAPIRANGA	SC
JABORA	SC
JARDINOPOLIS	SC
JOACABA	SC
JUPIA	SC
LACERDOPOLIS	SC
LAGES	SC
LAJEADO GRANDE	SC
LEBON REGIS	SC
LINDOIA DO SUL	SC
LUZERNA	SC
MACIEIRA	SC
MARAVILHA	SC
MAREMA	SC
MATOS COSTA	SC
MODELO	SC
MONDAI	SC
MONTE CARLO	SC
NOVA ERECHIM	SC
NOVA ITABERABA	SC
NOVO HORIZONTE	SC
OTACILIO COSTA	SC
OURO VERDE	SC
PAIAL	SC
PAINEL	SC
PALMA SOLA	SC
PALMEIRA	SC
PALMITOS	SC
PARAISO	SC
PASSOS MAIA	SC
PERITIBA	SC
PINHALZINHO	SC
PINHEIRO PRETO	SC
PIRATUBA	SC
PLANALTO ALEGRE	SC
PONTE ALTA	SC
PONTE ALTA DO NORTE	SC
PONTE SERRADA	SC
PORTO UNIAO	SC
PRESIDENTE CASTELO BRANCO	SC
PRINCESA	SC
QUILOMBO	SC
RIO DAS ANTAS	SC
RIO RUFINO	SC
RIQUEZA	SC
ROMELANDIA	SC
SALTINHO	SC
SALTO VELOSO	SC
SANTA CECILIA	SC
SANTA HELENA	SC
SANTA TEREZINHA DO PROGRESSO	SC
SANTIAGO DO SUL	SC
SAO BERNARDINO	SC
SAO CARLOS	SC
SAO CRISTOVAO DO SUL	SC
SAO DOMINGOS	SC
SAO JOAO DO OESTE	SC
SAO JOAQUIM	SC
SAO JOSE DO CEDRO	SC
SAO JOSE DO CERRITO	SC
SAO LOURENCO DO OESTE	SC
SAO MIGUEL DA BOA VISTA	SC
SAO MIGUEL DO OESTE	SC
SAUDADES	SC
SEARA	SC
SERRA ALTA	SC
SUL BRASIL	SC
TANGARA	SC
TIGRINHOS	SC
TIMBO GRANDE	SC
TREZE TILIAS	SC
TUNAPOLIS	SC
UNIAO DO OESTE	SC
URUBICI	SC
URUPEMA	SC
VARGEAO	SC
VARGEM	SC
VARGEM BONITA	SC
VIDEIRA	SC
XANXERE	SC
XAVANTINA	SC
XAXIM	SC
ZORTEA	SC
DDD 51
ALTO FELIZ	RS
ALVORADA	RS
AMARAL FERRADOR	RS
ANTA GORDA	RS
ARAMBARE	RS
ARARICA	RS
ARROIO DO MEIO	RS
ARROIO DO SAL	RS
ARROIO DO TIGRE	RS
ARROIO DOS RATOS	RS
ARVOREZINHA	RS
BALNEARIO PINHAL	RS
BARAO	RS
BARAO DO TRIUNFO	RS
BARRA DO RIBEIRO	RS
BOM PRINCIPIO	RS
BOM RETIRO DO SUL	RS
BOQUEIRAO DO LEAO	RS
BROCHIER	RS
BUTIA	RS
CACHOEIRA DO SUL	RS
CACHOEIRINHA	RS
CAMAQUA	RS
CAMPO BOM	RS
CANDELARIA	RS
CANOAS	RS
CAPAO DA CANOA	RS
CAPELA DE SANTANA	RS
CAPITAO	RS
CAPIVARI DO SUL	RS
CARAA	RS
CERRO BRANCO	RS
CERRO GRANDE DO SUL	RS
CHARQUEADAS	RS
CIDREIRA	RS
COLINAS	RS
COQUEIRO BAIXO	RS
CRISTAL	RS
CRUZEIRO DO SUL	RS
DOIS IRMAOS	RS
DOM FELICIANO	RS
DOM PEDRO DE ALCANTARA	RS
ELDORADO DO SUL	RS
ENCANTADO	RS
ENCRUZILHADA DO SUL	RS
ESTANCIA VELHA	RS
ESTEIO	RS
ESTRELA	RS
FAZENDA VILANOVA	RS
FELIZ	RS
GENERAL CAMARA	RS
GLORINHA	RS
GRAVATAI	RS
GUAIBA	RS
HARMONIA	RS
IBARAMA	RS
IGREJINHA	RS
ILOPOLIS	RS
IMBE	RS
IMIGRANTE	RS
ITATI	RS
IVOTI	RS
LAGOAO	RS
LAJEADO	RS
LINDOLFO COLLOR	RS
LINHA NOVA	RS
MAQUINE	RS
MARIANA PIMENTEL	RS
MARQUES DE SOUZA	RS
MATO LEITAO	RS
MINAS DO LEAO	RS
MONTENEGRO	RS
MORRINHOS DO SUL	RS
MORRO REUTER	RS
MOSTARDAS	RS
MUCUM	RS
NOVA BRESCIA	RS
NOVA HARTZ	RS
NOVA SANTA RITA	RS
NOVO HAMBURGO	RS
OSORIO	RS
PALMARES DO SUL	RS
PANTANO GRANDE	RS
PARECI NOVO	RS
PAROBE	RS
PASSO DO SOBRADO	RS
PAVERAMA	RS
POCO DAS ANTAS	RS
PORTAO	RS
PORTO ALEGRE	RS
POUSO NOVO	RS
PRESIDENTE LUCENA	RS
PROGRESSO	RS
PUTINGA	RS
RELVADO	RS
RIO PARDO	RS
RIOZINHO	RS
ROCA SALES	RS
ROLANTE	RS
SALVADOR DO SUL	RS
SANTA CLARA DO SUL	RS
SANTA CRUZ DO SUL	RS
SANTA MARIA DO HERVAL	RS
SANTO ANTONIO DA PATRULHA	RS
SAO JERONIMO	RS
SAO JOSE DO HORTENCIO	RS
SAO LEOPOLDO	RS
SAO SEBASTIAO DO CAI	RS
SAO VENDELINO	RS
SAPIRANGA	RS
SAPUCAIA DO SUL	RS
SEGREDO	RS
SENTINELA DO SUL	RS
SERIO	RS
SERTAO SANTANA	RS
SINIMBU	RS
SOBRADINHO	RS
TABAI	RS
TAPES	RS
TAQUARA	RS
TAQUARI	RS
TAVARES	RS
TERRA DE AREIA	RS
TEUTONIA	RS
TORRES	RS
TRAMANDAI	RS
TRAVESSEIRO	RS
TRES CACHOEIRAS	RS
TRES COROAS	RS
TRES FORQUILHAS	RS
TRIUNFO	RS
TUNAS	RS
TUPANDI	RS
VALE DO SOL	RS
VALE REAL	RS
VALE VERDE	RS
VENANCIO AIRES	RS
VERA CRUZ	RS
VESPASIANO CORREA	RS
VIAMAO	RS
XANGRI-LA	RS
DDD 53
ACEGUA	RS
ARROIO DO PADRE	RS
ARROIO GRANDE	RS
BAGE	RS
CANDIOTA	RS
CANGUCU	RS
CAPAO DO LEAO	RS
CERRITO	RS
CHUI	RS
DOM PEDRITO	RS
HERVAL	RS
HULHA NEGRA	RS
JAGUARAO	RS
MORRO REDONDO	RS
PEDRAS ALTAS	RS
PEDRO OSORIO	RS
PELOTAS	RS
PINHEIRO MACHADO	RS
PIRATINI	RS
RIO GRANDE	RS
SANTA VITORIA DO PALMAR	RS
SANTANA DA BOA VISTA	RS
SAO JOSE DO NORTE	RS
SAO LOURENCO DO SUL	RS
TURUCU	RS
DDD 54
AGUA SANTA	RS
ALTO ALEGRE	RS
ANDRE DA ROCHA	RS
ANTONIO PRADO	RS
ARATIBA	RS
AUREA	RS
BARAO DE COTEGIPE	RS
BARRA FUNDA	RS
BARRACAO	RS
BARROS CASSAL	RS
BENTO GONCALVES	RS
BOA VISTA DO SUL	RS
BOM JESUS	RS
CACIQUE DOBLE	RS
CAMARGO	RS
CAMBARA DO SUL	RS
CAMPESTRE DA SERRA	RS
CAMPINAS DO SUL	RS
CAMPOS BORGES	RS
CANELA	RS
CAPAO BONITO DO SUL	RS
CARAZINHO	RS
CARLOS BARBOSA	RS
CASCA	RS
CASEIROS	RS
CAXIAS DO SUL	RS
CHAPADA	RS
CHARRUA	RS
CIRIACO	RS
COLORADO	RS
CONSTANTINA	RS
CORONEL PILAR	RS
COTIPORA	RS
COXILHA	RS
DAVID CANABARRO	RS
DOIS LAJEADOS	RS
ENGENHO VELHO	RS
ENTRE RIOS DO SUL	RS
EREBANGO	RS
ERECHIM	RS
ERNESTINA	RS
ERVAL GRANDE	RS
ESMERALDA	RS
ESPUMOSO	RS
ESTACAO	RS
FAGUNDES VARELA	RS
FARROUPILHA	RS
FAXINALZINHO	RS
FLORES DA CUNHA	RS
FONTOURA XAVIER	RS
GARIBALDI	RS
GAURAMA	RS
GETULIO VARGAS	RS
GRAMADO	RS
GUABIJU	RS
GUAPORE	RS
IBIACA	RS
IBIRAIARAS	RS
IBIRAPUITA	RS
IBIRUBA	RS
IPE	RS
IPIRANGA DO SUL	RS
ITATIBA DO SUL	RS
JACUTINGA	RS
JAQUIRANA	RS
LAGOA DOS TRES CANTOS	RS
LAGOA VERMELHA	RS
MACHADINHO	RS
MARAU	RS
MARCELINO RAMOS	RS
MARIANO MORO	RS
MATO CASTELHANO	RS
MAXIMILIANO DE ALMEIDA	RS
MONTAURI	RS
MONTE ALEGRE DOS CAMPOS	RS
MONTE BELO DO SUL	RS
MORMACO	RS
MULITERNO	RS
NAO-ME-TOQUE	RS
NONOAI	RS
NOVA ALVORADA	RS
NOVA ARACA	RS
NOVA BASSANO	RS
NOVA BOA VISTA	RS
NOVA PADUA	RS
NOVA PETROPOLIS	RS
NOVA PRATA	RS
NOVA ROMA DO SUL	RS
PAIM FILHO	RS
PARAI	RS
PASSO FUNDO	RS
PAULO BENTO	RS
PICADA CAFE	RS
PINHAL DA SERRA	RS
PONTE PRETA	RS
PROTASIO ALVES	RS
QUATRO IRMAOS	RS
QUINZE DE NOVEMBRO	RS
RONDA ALTA	RS
RONDINHA	RS
SANANDUVA	RS
SANTA TEREZA	RS
SANTO ANTONIO DO PALMA	RS
SANTO ANTONIO DO PLANALTO	RS
SANTO EXPEDITO DO SUL	RS
SAO DOMINGOS DO SUL	RS
SAO FRANCISCO DE PAULA	RS
SAO JOAO DA URTIGA	RS
SAO JORGE	RS
SAO JOSE DO HERVAL	RS
SAO JOSE DO OURO	RS
SAO JOSE DOS AUSENTES	RS
SAO MARCOS	RS
SAO VALENTIM	RS
SAO VALENTIM DO SUL	RS
SARANDI	RS
SELBACH	RS
SERAFINA CORREA	RS
SERTAO	RS
SEVERIANO DE ALMEIDA	RS
SOLEDADE	RS
TAPEJARA	RS
TAPERA	RS
TIO HUGO	RS
TRES ARROIOS	RS
TRES PALMEIRAS	RS
TRINDADE DO SUL	RS
UNIAO DA SERRA	RS
VACARIA	RS
VANINI	RS
VERANOPOLIS	RS
VIADUTOS	RS
VICTOR GRAEFF	RS
VILA FLORES	RS
VILA LANGARO	RS
VILA MARIA	RS
VISTA ALEGRE DO PRATA	RS
DDD 55
AGUDO	RS
AJURICABA	RS
ALECRIM	RS
ALEGRETE	RS
ALEGRIA	RS
ALPESTRE	RS
AMETISTA DO SUL	RS
AUGUSTO PESTANA	RS
BARRA DO QUARAI	RS
BOA VISTA DAS MISSOES	RS
BOA VISTA DO BURICA	RS
BOA VISTA DO CADEADO	RS
BOM PROGRESSO	RS
BOSSOROCA	RS
BRAGA	RS
CACAPAVA DO SUL	RS
CACEQUI	RS
CAIBATE	RS
CAICARA	RS
CAMPINA DAS MISSOES	RS
CAMPO NOVO	RS
CANDIDO GODOI	RS
CAPAO DO CIPO	RS
CATUIPE	RS
CERRO GRANDE	RS
CERRO LARGO	RS
CHIAPETTA	RS
CONDOR	RS
CORONEL BARROS	RS
CORONEL BICACO	RS
CRISSIUMAL	RS
CRUZ ALTA	RS
DEZESSEIS DE NOVEMBRO	RS
DOIS IRMAOS DAS MISSOES	RS
DONA FRANCISCA	RS
DOUTOR MAURICIO CARDOSO	RS
ENTRE-IJUIS	RS
ERVAL SECO	RS
EUGENIO DE CASTRO	RS
FAXINAL DO SOTURNO	RS
FORMIGUEIRO	RS
FORTALEZA DOS VALOS	RS
FREDERICO WESTPHALEN	RS
GIRUA	RS
GUARANI DAS MISSOES	RS
HORIZONTINA	RS
HUMAITA	RS
IJUI	RS
INDEPENDENCIA	RS
INHACORA	RS
IRAI	RS
ITAARA	RS
ITACURUBI	RS
ITAQUI	RS
IVORA	RS
JABOTICABA	RS
JACUIZINHO	RS
JAGUARI	RS
JARI	RS
JOIA	RS
JULIO DE CASTILHOS	RS
LAVRAS DO SUL	RS
LIBERATO SALZANO	RS
MACAMBARA	RS
MANOEL VIANA	RS
MATA	RS
MIRAGUAI	RS
NOVA ESPERANCA DO SUL	RS
NOVA PALMA	RS
NOVO BARREIRO	RS
NOVO MACHADO	RS
NOVO TIRADENTES	RS
PALMEIRA DAS MISSOES	RS
PALMITINHO	RS
PANAMBI	RS
PARAISO DO SUL	RS
PEJUCARA	RS
PINHAL	RS
PINHAL GRANDE	RS
PINHEIRINHO DO VALE	RS
PIRAPO	RS
PLANALTO	RS
PORTO LUCENA	RS
PORTO MAUA	RS
PORTO XAVIER	RS
QUARAI	RS
QUEVEDOS	RS
REDENTORA	RS
RESTINGA SECA	RS
RODEIO BONITO	RS
ROQUE GONZALES	RS
ROSARIO DO SUL	RS
SALDANHA MARINHO	RS
SALTO DO JACUI	RS
SALVADOR DAS MISSOES	RS
SANTA BARBARA DO SUL	RS
SANTA MARGARIDA DO SUL	RS
SANTA MARIA	RS
SANTA ROSA	RS
SANTANA DO LIVRAMENTO	RS
SANTIAGO	RS
SANTO ANGELO	RS
SANTO ANTONIO DAS MISSOES	RS
SANTO AUGUSTO	RS
SANTO CRISTO	RS
SAO BORJA	RS
SAO FRANCISCO DE ASSIS	RS
SAO GABRIEL	RS
SAO JOAO DO POLESINE	RS
SAO JOSE DAS MISSOES	RS
SAO JOSE DO INHACORA	RS
SAO LUIZ GONZAGA	RS
SAO MARTINHO	RS
SAO MARTINHO DA SERRA	RS
SAO MIGUEL DAS MISSOES	RS
SAO NICOLAU	RS
SAO PAULO DAS MISSOES	RS
SAO PEDRO DAS MISSOES	RS
SAO PEDRO DO BUTIA	RS
SAO PEDRO DO SUL	RS
SAO SEPE	RS
SAO VICENTE DO SUL	RS
SEBERI	RS
SEDE NOVA	RS
SENADOR SALGADO FILHO	RS
SILVEIRA MARTINS	RS
TAQUARUCU DO SUL	RS
TENENTE PORTELA	RS
TOROPI	RS
TRES DE MAIO	RS
TRES PASSOS	RS
TUCUNDUVA	RS
TUPANCIRETA	RS
TUPARENDI	RS
URUGUAIANA	RS
VICENTE DUTRA	RS
VILA NOVA DO SUL	RS
VISTA ALEGRE	RS
VISTA GAUCHA	RS
DDD 61
AGUAS LINDAS DE GOIAS	GO
BRASILIA	DF
CABECEIRAS	GO
CIDADE OCIDENTAL	GO
CRISTALINA	GO
FORMOSA	GO
LUZIANIA	GO
NOVO GAMA	GO
PADRE BERNARDO	GO
PLANALTINA	GO
SANTO ANTONIO DO DESCOBERTO	GO
VALPARAISO DE GOIAS	GO
DDD 62
ABADIA DE GOIAS	GO
ABADIANIA	GO
AGUA FRIA DE GOIAS	GO
ALEXANIA	GO
ALTO HORIZONTE	GO
ALTO PARAISO DE GOIAS	GO
ALVORADA DO NORTE	GO
AMARALINA	GO
ANAPOLIS	GO
APARECIDA DE GOIANIA	GO
ARACU	GO
ARAGOIANIA	GO
ARAGUAPAZ	GO
ARUANA	GO
BARRO ALTO	GO
BELA VISTA DE GOIAS	GO
BONFINOPOLIS	GO
BONOPOLIS	GO
BRAZABRANTES	GO
BRITANIA	GO
BURITINOPOLIS	GO
CALDAZINHA	GO
CAMPESTRE DE GOIAS	GO
CAMPINACU	GO
CAMPINORTE	GO
CAMPO LIMPO DE GOIAS	GO
CAMPOS BELOS	GO
CAMPOS VERDES	GO
CARMO DO RIO VERDE	GO
CATURAI	GO
CAVALCANTE	GO
CERES	GO
COCALZINHO DE GOIAS	GO
COLINAS DO SUL	GO
CORUMBA DE GOIAS	GO
CRIXAS	GO
DAMIANOPOLIS	GO
DAMOLANDIA	GO
DIVINOPOLIS DE GOIAS	GO
ESTRELA DO NORTE	GO
FAINA	GO
FAZENDA NOVA	GO
FLORES DE GOIAS	GO
FORMOSO	GO
GAMELEIRA DE GOIAS	GO
GOIANAPOLIS	GO
GOIANESIA	GO
GOIANIA	GO
GOIANIRA	GO
GOIAS	GO
GUAPO	GO
GUARAITA	GO
GUARANI DE GOIAS	GO
GUARINOS	GO
HEITORAI	GO
HIDROLANDIA	GO
HIDROLINA	GO
IACIARA	GO
INHUMAS	GO
IPIRANGA DE GOIAS	GO
ITABERAI	GO
ITAGUARI	GO
ITAGUARU	GO
ITAPACI	GO
ITAPIRAPUA	GO
ITAPURANGA	GO
ITAUCU	GO
JARAGUA	GO
JESUPOLIS	GO
JUSSARA	GO
LEOPOLDO DE BULHOES	GO
MAMBAI	GO
MARA ROSA	GO
MATRINCHA	GO
MIMOSO DE GOIAS	GO
MINACU	GO
MONTE ALEGRE DE GOIAS	GO
MONTES CLAROS DE GOIAS	GO
MONTIVIDIU DO NORTE	GO
MORRO AGUDO DE GOIAS	GO
MOZARLANDIA	GO
MUNDO NOVO	GO
MUTUNOPOLIS	GO
NEROPOLIS	GO
NIQUELANDIA	GO
NOVA AMERICA	GO
NOVA CRIXAS	GO
NOVA GLORIA	GO
NOVA IGUACU DE GOIAS	GO
NOVA ROMA	GO
NOVA VENEZA	GO
NOVO BRASIL	GO
NOVO PLANALTO	GO
OURO VERDE DE GOIAS	GO
PETROLINA DE GOIAS	GO
PILAR DE GOIAS	GO
PIRENOPOLIS	GO
PORANGATU	GO
POSSE	GO
RIALMA	GO
RIANAPOLIS	GO
RUBIATABA	GO
SANTA BARBARA DE GOIAS	GO
SANTA FE DE GOIAS	GO
SANTA ISABEL	GO
SANTA RITA DO NOVO DESTINO	GO
SANTA ROSA DE GOIAS	GO
SANTA TEREZA DE GOIAS	GO
SANTA TEREZINHA DE GOIAS	GO
SANTO ANTONIO DE GOIAS	GO
SAO DOMINGOS	GO
SAO FRANCISCO DE GOIAS	GO
SAO JOAO D'ALIANCA	GO
SAO LUIZ DO NORTE	GO
SAO MIGUEL DO ARAGUAIA	GO
SAO MIGUEL DO PASSA QUATRO	GO
SAO PATRICIO	GO
SENADOR CANEDO	GO
SILVANIA	GO
SIMOLANDIA	GO
SITIO D'ABADIA	GO
TAQUARAL DE GOIAS	GO
TERESINA DE GOIAS	GO
TEREZOPOLIS DE GOIAS	GO
TRINDADE	GO
TROMBAS	GO
UIRAPURU	GO
URUACU	GO
URUANA	GO
VARJAO	GO
VIANOPOLIS	GO
VILA BOA	GO
VILA PROPICIO	GO
DDD 63
ABREULANDIA	TO
AGUIARNOPOLIS	TO
ALIANCA DO TOCANTINS	TO
ALMAS	TO
ALVORADA	TO
ANANAS	TO
ANGICO	TO
APARECIDA DO RIO NEGRO	TO
ARAGOMINAS	TO
ARAGUACEMA	TO
ARAGUACU	TO
ARAGUAINA	TO
ARAGUANA	TO
ARAGUATINS	TO
ARAPOEMA	TO
ARRAIAS	TO
AUGUSTINOPOLIS	TO
AURORA DO TOCANTINS	TO
AXIXA DO TOCANTINS	TO
BABACULANDIA	TO
BANDEIRANTES DO TOCANTINS	TO
BARRA DO OURO	TO
BARROLANDIA	TO
BERNARDO SAYAO	TO
BOM JESUS DO TOCANTINS	TO
BRASILANDIA DO TOCANTINS	TO
BREJINHO DE NAZARE	TO
BURITI DO TOCANTINS	TO
CACHOEIRINHA	TO
CAMPOS LINDOS	TO
CARIRI DO TOCANTINS	TO
CARMOLANDIA	TO
CARRASCO BONITO	TO
CASEARA	TO
CENTENARIO	TO
CHAPADA DA NATIVIDADE	TO
CHAPADA DE AREIA	TO
COLINAS DO TOCANTINS	TO
COLMEIA	TO
COMBINADO	TO
CONCEICAO DO TOCANTINS	TO
COUTO DE MAGALHAES	TO
CRISTALANDIA	TO
CRIXAS DO TOCANTINS	TO
DARCINOPOLIS	TO
DIANOPOLIS	TO
DIVINOPOLIS DO TOCANTINS	TO
DOIS IRMAOS DO TOCANTINS	TO
DUERE	TO
ESPERANTINA	TO
FATIMA	TO
FIGUEIROPOLIS	TO
FILADELFIA	TO
FORMOSO DO ARAGUAIA	TO
FORTALEZA DO TABOCAO	TO
GOIANORTE	TO
GOIATINS	TO
GUARAI	TO
GURUPI	TO
IPUEIRAS	TO
ITACAJA	TO
ITAGUATINS	TO
ITAPIRATINS	TO
ITAPORA DO TOCANTINS	TO
JAU DO TOCANTINS	TO
JUARINA	TO
LAGOA DA CONFUSAO	TO
LAGOA DO TOCANTINS	TO
LAJEADO	TO
LAVANDEIRA	TO
LIZARDA	TO
LUZINOPOLIS	TO
MARIANOPOLIS DO TOCANTINS	TO
MATEIROS	TO
MAURILANDIA DO TOCANTINS	TO
MIRACEMA DO TOCANTINS	TO
MIRANORTE	TO
MONTE DO CARMO	TO
MURICILANDIA	TO
NATIVIDADE	TO
NAZARE	TO
NOVA OLINDA	TO
NOVA ROSALANDIA	TO
NOVO ACORDO	TO
NOVO ALEGRE	TO
NOVO JARDIM	TO
PALMAS	TO
PALMEIRANTE	TO
PALMEIRAS DO TOCANTINS	TO
PALMEIROPOLIS	TO
PARAISO DO TOCANTINS	TO
PARANA	TO
PAU D'ARCO	TO
PEDRO AFONSO	TO
PEIXE	TO
PEQUIZEIRO	TO
PINDORAMA DO TOCANTINS	TO
PIRAQUE	TO
PIUM	TO
PONTE ALTA DO BOM JESUS	TO
PONTE ALTA DO TOCANTINS	TO
PORTO ALEGRE DO TOCANTINS	TO
PORTO NACIONAL	TO
PRAIA NORTE	TO
PRESIDENTE KENNEDY	TO
PUGMIL	TO
RECURSOLANDIA	TO
RIACHINHO	TO
RIO DA CONCEICAO	TO
RIO DOS BOIS	TO
RIO SONO	TO
SAMPAIO	TO
SANDOLANDIA	TO
SANTA FE DO ARAGUAIA	TO
SANTA MARIA DO TOCANTINS	TO
SANTA RITA DO TOCANTINS	TO
SANTA ROSA DO TOCANTINS	TO
SANTA TEREZA DO TOCANTINS	TO
SANTA TEREZINHA DO TOCANTINS	TO
SAO BENTO DO TOCANTINS	TO
SAO FELIX DO TOCANTINS	TO
SAO MIGUEL DO TOCANTINS	TO
SAO SALVADOR DO TOCANTINS	TO
SAO SEBASTIAO DO TOCANTINS	TO
SAO VALERIO DA NATIVIDADE	TO
SILVANOPOLIS	TO
SITIO NOVO DO TOCANTINS	TO
SUCUPIRA	TO
TAGUATINGA	TO
TALISMA	TO
TOCANTINIA	TO
TOCANTINOPOLIS	TO
TUPIRAMA	TO
TUPIRATINS	TO
WANDERLANDIA	TO
XAMBIOA	TO
DDD 64
ACREUNA	GO
ADELANDIA	GO
AGUA LIMPA	GO
ALOANDIA	GO
AMERICANO DO BRASIL	GO
AMORINOPOLIS	GO
ANHANGUERA	GO
ANICUNS	GO
APARECIDA DO RIO DOCE	GO
APORE	GO
ARAGARCAS	GO
ARENOPOLIS	GO
AURILANDIA	GO
AVELINOPOLIS	GO
BOM JARDIM DE GOIAS	GO
BOM JESUS DE GOIAS	GO
BURITI ALEGRE	GO
BURITI DE GOIAS	GO
CACHOEIRA ALTA	GO
CACHOEIRA DE GOIAS	GO
CACHOEIRA DOURADA	GO
CACU	GO
CAIAPONIA	GO
CALDAS NOVAS	GO
CAMPO ALEGRE DE GOIAS	GO
CASTELANDIA	GO
CATALAO	GO
CEZARINA	GO
CHAPADAO DO CEU	GO
CORREGO DO OURO	GO
CORUMBAIBA	GO
CRISTIANOPOLIS	GO
CROMINIA	GO
CUMARI	GO
DAVINOPOLIS	GO
DIORAMA	GO
DOVERLANDIA	GO
EDEALINA	GO
EDEIA	GO
FIRMINOPOLIS	GO
GOIANDIRA	GO
GOIATUBA	GO
GOUVELANDIA	GO
INACIOLANDIA	GO
INDIARA	GO
IPAMERI	GO
IPORA	GO
ISRAELANDIA	GO
ITAJA	GO
ITARUMA	GO
ITUMBIARA	GO
IVOLANDIA	GO
JANDAIA	GO
JATAI	GO
JAUPACI	GO
JOVIANIA	GO
LAGOA SANTA	GO
MAIRIPOTABA	GO
MARZAGAO	GO
MAURILANDIA	GO
MINEIROS	GO
MOIPORA	GO
MONTIVIDIU	GO
MORRINHOS	GO
MOSSAMEDES	GO
NAZARIO	GO
NOVA AURORA	GO
ORIZONA	GO
OUVIDOR	GO
PALESTINA DE GOIAS	GO
PALMEIRAS DE GOIAS	GO
PALMELO	GO
PALMINOPOLIS	GO
PANAMA	GO
PARANAIGUARA	GO
PARAUNA	GO
PEROLANDIA	GO
PIRACANJUBA	GO
PIRANHAS	GO
PIRES DO RIO	GO
PONTALINA	GO
PORTEIRAO	GO
PORTELANDIA	GO
PROFESSOR JAMIL	GO
QUIRINOPOLIS	GO
RIO QUENTE	GO
RIO VERDE	GO
SANCLERLANDIA	GO
SANTA CRUZ DE GOIAS	GO
SANTA HELENA DE GOIAS	GO
SANTA RITA DO ARAGUAIA	GO
SANTO ANTONIO DA BARRA	GO
SAO JOAO DA PARAUNA	GO
SAO LUIS DE MONTES BELOS	GO
SAO SIMAO	GO
SERRANOPOLIS	GO
TRES RANCHOS	GO
TURVANIA	GO
TURVELANDIA	GO
URUTAI	GO
VICENTINOPOLIS	GO
DDD 65
ACORIZAL	MT
ALTO PARAGUAI	MT
ARAPUTANGA	MT
ARENAPOLIS	MT
BARAO DE MELGACO	MT
BARRA DO BUGRES	MT
CACERES	MT
CAMPO NOVO DO PARECIS	MT
CAMPOS DE JULIO	MT
CHAPADA DOS GUIMARAES	MT
COMODORO	MT
CONQUISTA D'OESTE	MT
CUIABA	MT
CURVELANDIA	MT
DENISE	MT
DIAMANTINO	MT
FIGUEIROPOLIS D'OESTE	MT
GLORIA D'OESTE	MT
INDIAVAI	MT
ITIQUIRA	MT
JANGADA	MT
JAURU	MT
LAMBARI D'OESTE	MT
LUCAS DO RIO VERDE	MT
MIRASSOL D'OESTE	MT
NOBRES	MT
NORTELANDIA	MT
NOSSA SENHORA DO LIVRAMENTO	MT
NOVA LACERDA	MT
NOVA MARILANDIA	MT
NOVA MUTUM	MT
NOVA OLIMPIA	MT
POCONE	MT
PONTES E LACERDA	MT
PORTO ESPERIDIAO	MT
PORTO ESTRELA	MT
RESERVA DO CABACAL	MT
RIO BRANCO	MT
ROSARIO OESTE	MT
SALTO DO CEU	MT
SANTA RITA DO TRIVELATO	MT
SANTO AFONSO	MT
SANTO ANTONIO DO LEVERGER	MT
SAO JOSE DOS QUATRO MARCOS	MT
SAPEZAL	MT
TANGARA DA SERRA	MT
VALE DE SAO DOMINGOS	MT
VARZEA GRANDE	MT
VILA BELA DA SANTISSIMA TRINDADE	MT
DDD 66
AGUA BOA	MT
ALTA FLORESTA	MT
ALTO ARAGUAIA	MT
ALTO BOA VISTA	MT
ALTO GARCAS	MT
ALTO TAQUARI	MT
APIACAS	MT
ARAGUAIANA	MT
ARAGUAINHA	MT
ARIPUANA	MT
BARRA DO GARCAS	MT
BOM JESUS DO ARAGUAIA	MT
BRASNORTE	MT
CAMPINAPOLIS	MT
CAMPO VERDE	MT
CANARANA	MT
CARLINDA	MT
CASTANHEIRA	MT
CLAUDIA	MT
COCALINHO	MT
COLIDER	MT
COLNIZA	MT
CONFRESA	MT
COTRIGUACU	MT
DOM AQUINO	MT
FELIZ NATAL	MT
GAUCHA DO NORTE	MT
GENERAL CARNEIRO	MT
GUARANTA DO NORTE	MT
GUIRATINGA	MT
ITAUBA	MT
JACIARA	MT
JUARA	MT
JUINA	MT
JURUENA	MT
JUSCIMEIRA	MT
LUCIARA	MT
MARCELANDIA	MT
MATUPA	MT
NOVA BANDEIRANTES	MT
NOVA BRASILANDIA	MT
NOVA CANAA DO NORTE	MT
NOVA GUARITA	MT
NOVA MARINGA	MT
NOVA MONTE VERDE	MT
NOVA SANTA HELENA	MT
NOVA UBIRATA	MT
NOVA XAVANTINA	MT
NOVO HORIZONTE DO NORTE	MT
NOVO MUNDO	MT
NOVO SANTO ANTONIO	MT
NOVO SAO JOAQUIM	MT
PARANAITA	MT
PARANATINGA	MT
PEDRA PRETA	MT
PEIXOTO DE AZEVEDO	MT
PLANALTO DA SERRA	MT
PONTAL DO ARAGUAIA	MT
PONTE BRANCA	MT
PORTO ALEGRE DO NORTE	MT
PORTO DOS GAUCHOS	MT
POXOREO	MT
PRIMAVERA DO LESTE	MT
QUERENCIA	MT
RIBEIRAO CASCALHEIRA	MT
RIBEIRAOZINHO	MT
RONDOLANDIA	MT
RONDONOPOLIS	MT
SANTA CARMEM	MT
SANTA CRUZ DO XINGU	MT
SANTA TEREZINHA	MT
SANTO ANTONIO DO LESTE	MT
SAO FELIX DO ARAGUAIA	MT
SAO JOSE DO POVO	MT
SAO JOSE DO RIO CLARO	MT
SAO JOSE DO XINGU	MT
SAO PEDRO DA CIPA	MT
SERRA NOVA DOURADA	MT
SINOP	MT
SORRISO	MT
TABAPORA	MT
TAPURAH	MT
TERRA NOVA DO NORTE	MT
TESOURO	MT
TORIXOREU	MT
UNIAO DO SUL	MT
VERA	MT
VILA RICA	MT
DDD 67
AGUA CLARA	MS
ALCINOPOLIS	MS
AMAMBAI	MS
ANASTACIO	MS
ANAURILANDIA	MS
ANGELICA	MS
ANTONIO JOAO	MS
APARECIDA DO TABOADO	MS
AQUIDAUANA	MS
ARAL MOREIRA	MS
BANDEIRANTES	MS
BATAGUASSU	MS
BATAYPORA	MS
BELA VISTA	MS
BODOQUENA	MS
BONITO	MS
BRASILANDIA	MS
CAARAPO	MS
CAMAPUA	MS
CAMPO GRANDE	MS
CARACOL	MS
CASSILANDIA	MS
CHAPADAO DO SUL	MS
CORGUINHO	MS
CORONEL SAPUCAIA	MS
CORUMBA	MS
COSTA RICA	MS
COXIM	MS
DEODAPOLIS	MS
DOIS IRMAOS DO BURITI	MS
DOURADINA	MS
DOURADOS	MS
ELDORADO	MS
FATIMA DO SUL	MS
GLORIA DE DOURADOS	MS
GUIA LOPES DA LAGUNA	MS
IGUATEMI	MS
INOCENCIA	MS
ITAPORA	MS
ITAQUIRAI	MS
IVINHEMA	MS
JAPORA	MS
JARAGUARI	MS
JARDIM	MS
JATEI	MS
JUTI	MS
LADARIO	MS
LAGUNA CARAPA	MS
MARACAJU	MS
MIRANDA	MS
MUNDO NOVO	MS
NAVIRAI	MS
NIOAQUE	MS
NOVA ALVORADA DO SUL	MS
NOVA ANDRADINA	MS
NOVO HORIZONTE DO SUL	MS
PARANAIBA	MS
PARANHOS	MS
PEDRO GOMES	MS
PONTA PORA	MS
PORTO MURTINHO	MS
RIBAS DO RIO PARDO	MS
RIO BRILHANTE	MS
RIO NEGRO	MS
RIO VERDE DE MATO GROSSO	MS
ROCHEDO	MS
SANTA RITA DO PARDO	MS
SAO GABRIEL DO OESTE	MS
SELVIRIA	MS
SETE QUEDAS	MS
SIDROLANDIA	MS
SONORA	MS
TACURU	MS
TAQUARUSSU	MS
TERENOS	MS
TRES LAGOAS	MS
VICENTINA	MS
DDD 68
ACRELANDIA	AC
ASSIS BRASIL	AC
BRASILEIA	AC
BUJARI	AC
CAPIXABA	AC
CRUZEIRO DO SUL	AC
EPITACIOLANDIA	AC
FEIJO	AC
JORDAO	AC
MANCIO LIMA	AC
MANOEL URBANO	AC
MARECHAL THAUMATURGO	AC
PLACIDO DE CASTRO	AC
PORTO ACRE	AC
PORTO WALTER	AC
RIO BRANCO	AC
RODRIGUES ALVES	AC
SANTA ROSA DO PURUS	AC
SENA MADUREIRA	AC
SENADOR GUIOMARD	AC
TARAUACA	AC
XAPURI	AC
DDD 69
ALTA FLORESTA D'OESTE	RO
ALTO ALEGRE DOS PARECIS	RO
ALTO PARAISO	RO
ALVORADA D'OESTE	RO
ARIQUEMES	RO
BURITIS	RO
CABIXI	RO
CACAULANDIA	RO
CACOAL	RO
CAMPO NOVO DE RONDONIA	RO
CANDEIAS DO JAMARI	RO
CASTANHEIRAS	RO
CEREJEIRAS	RO
CHUPINGUAIA	RO
COLORADO DO OESTE	RO
CORUMBIARA	RO
COSTA MARQUES	RO
CUJUBIM	RO
ESPIGAO D'OESTE	RO
GOVERNADOR JORGE TEIXEIRA	RO
GUAJARA-MIRIM	RO
ITAPUA DO OESTE	RO
JARU	RO
JI-PARANA	RO
MACHADINHO D'OESTE	RO
MINISTRO ANDREAZZA	RO
MIRANTE DA SERRA	RO
MONTE NEGRO	RO
NOVA BRASILANDIA D'OESTE	RO
NOVA MAMORE	RO
NOVA UNIAO	RO
NOVO HORIZONTE DO OESTE	RO
OURO PRETO DO OESTE	RO
PARECIS	RO
PIMENTA BUENO	RO
PIMENTEIRAS DO OESTE	RO
PORTO VELHO	RO
PRESIDENTE MEDICI	RO
PRIMAVERA DE RONDONIA	RO
RIO CRESPO	RO
ROLIM DE MOURA	RO
SANTA LUZIA D'OESTE	RO
SAO FELIPE D'OESTE	RO
SAO FRANCISCO DO GUAPORE	RO
SAO MIGUEL DO GUAPORE	RO
SERINGUEIRAS	RO
TEIXEIROPOLIS	RO
THEOBROMA	RO
URUPA	RO
VALE DO ANARI	RO
VALE DO PARAISO	RO
VILHENA	RO
DDD 71
CAMACARI	BA
CANDEIAS	BA
CATU	BA
DIAS D'AVILA	BA
ITAPARICA	BA
LAURO DE FREITAS	BA
MADRE DE DEUS	BA
MATA DE SAO JOAO	BA
POJUCA	BA
SALVADOR	BA
SAO FRANCISCO DO CONDE	BA
SAO SEBASTIAO DO PASSE	BA
SIMOES FILHO	BA
VERA CRUZ	BA
DDD 73
AIQUARA	BA
ALCOBACA	BA
ALMADINA	BA
APUAREMA	BA
ARATACA	BA
AURELINO LEAL	BA
BARRA DO ROCHA	BA
BELMONTE	BA
BUERAREMA	BA
CAMACAN	BA
CAMAMU	BA
CANAVIEIRAS	BA
CARAVELAS	BA
COARACI	BA
CRAVOLANDIA	BA
DARIO MEIRA	BA
EUNAPOLIS	BA
FIRMINO ALVES	BA
FLORESTA AZUL	BA
GANDU	BA
GONGOGI	BA
GOVERNADOR LOMANTO JUNIOR	BA
GUARATINGA	BA
IBICARAI	BA
IBICUI	BA
IBIRAPITANGA	BA
IBIRAPUA	BA
IBIRATAIA	BA
IGRAPIUNA	BA
IGUAI	BA
ILHEUS	BA
IPIAU	BA
IRAJUBA	BA
ITABELA	BA
ITABUNA	BA
ITACARE	BA
ITAGI	BA
ITAGIBA	BA
ITAGIMIRIM	BA
ITAJU DO COLONIA	BA
ITAJUIPE	BA
ITAMARAJU	BA
ITAMARI	BA
ITANHEM	BA
ITAPE	BA
ITAPEBI	BA
ITAPITANGA	BA
ITAQUARA	BA
ITARANTIM	BA
ITIRUCU	BA
ITORORO	BA
ITUBERA	BA
JAGUAQUARA	BA
JEQUIE	BA
JITAUNA	BA
JUCURUCU	BA
JUSSARI	BA
LAFAIETE COUTINHO	BA
LAJEDAO	BA
LAJEDO DO TABOCAL	BA
MANOEL VITORINO	BA
MARACAS	BA
MARAU	BA
MASCOTE	BA
MEDEIROS NETO	BA
MUCURI	BA
NILO PECANHA	BA
NOVA CANAA	BA
NOVA IBIA	BA
NOVA ITARANA	BA
NOVA VICOSA	BA
PAU BRASIL	BA
PIRAI DO NORTE	BA
PLANALTINO	BA
PORTO SEGURO	BA
POTIRAGUA	BA
PRADO	BA
PRESIDENTE TANCREDO NEVES	BA
SANTA CRUZ CABRALIA	BA
SANTA CRUZ DA VITORIA	BA
SANTA INES	BA
SANTA LUZIA	BA
SAO JOSE DA VITORIA	BA
TEIXEIRA DE FREITAS	BA
TEOLANDIA	BA
UBAITABA	BA
UBATA	BA
UNA	BA
URUCUCA	BA
VEREDA	BA
WENCESLAU GUIMARAES	BA
DDD 74
AMERICA DOURADA	BA
ANDORINHA	BA
ANTONIO GONCALVES	BA
BAIXA GRANDE	BA
BARRA	BA
BARRA DO MENDES	BA
BARRO ALTO	BA
CAEM	BA
CAFARNAUM	BA
CALDEIRAO GRANDE	BA
CAMPO ALEGRE DE LOURDES	BA
CAMPO FORMOSO	BA
CANARANA	BA
CAPIM GROSSO	BA
CASA NOVA	BA
CENTRAL	BA
CURACA	BA
FILADELFIA	BA
GENTIO DO OURO	BA
IBIPEBA	BA
IBITITA	BA
IRECE	BA
ITAGUACU DA BAHIA	BA
ITIUBA	BA
JACOBINA	BA
JAGUARARI	BA
JOAO DOURADO	BA
JUAZEIRO	BA
JUSSARA	BA
LAPAO	BA
MACAJUBA	BA
MAIRI	BA
MIGUEL CALMON	BA
MIRANGABA	BA
MORRO DO CHAPEU	BA
MULUNGU DO MORRO	BA
MUNDO NOVO	BA
OUROLANDIA	BA
PILAO ARCADO	BA
PINDOBACU	BA
PIRITIBA	BA
PONTO NOVO	BA
PRESIDENTE DUTRA	BA
QUIXABEIRA	BA
REMANSO	BA
SAO GABRIEL	BA
SAO JOSE DO JACUIPE	BA
SAUDE	BA
SENHOR DO BONFIM	BA
SENTO SE	BA
SERROLANDIA	BA
SOBRADINHO	BA
TAPIRAMUTA	BA
UAUA	BA
UIBAI	BA
UMBURANAS	BA
VARZEA DA ROCA	BA
VARZEA DO POCO	BA
VARZEA NOVA	BA
XIQUE-XIQUE	BA
DDD 75
ABARE	BA
ACAJUTIBA	BA
ADUSTINA	BA
AGUA FRIA	BA
ALAGOINHAS	BA
AMARGOSA	BA
AMELIA RODRIGUES	BA
ANDARAI	BA
ANGUERA	BA
ANTAS	BA
ANTONIO CARDOSO	BA
APORA	BA
ARACAS	BA
ARACI	BA
ARAMARI	BA
ARATUIPE	BA
BANZAE	BA
BARROCAS	BA
BIRITINGA	BA
BOA VISTA DO TUPIM	BA
BONINAL	BA
BONITO	BA
BREJOES	BA
CABACEIRAS DO PARAGUACU	BA
CACHOEIRA	BA
CAIRU	BA
CANDEAL	BA
CANSANCAO	BA
CANUDOS	BA
CAPELA DO ALTO ALEGRE	BA
CARDEAL DA SILVA	BA
CASTRO ALVES	BA
CHORROCHO	BA
CICERO DANTAS	BA
CIPO	BA
CONCEICAO DA FEIRA	BA
CONCEICAO DO ALMEIDA	BA
CONCEICAO DO COITE	BA
CONCEICAO DO JACUIPE	BA
CONDE	BA
CORACAO DE MARIA	BA
CORONEL JOAO SA	BA
CRISOPOLIS	BA
CRUZ DAS ALMAS	BA
DOM MACEDO COSTA	BA
ELISIO MEDRADO	BA
ENTRE RIOS	BA
ESPLANADA	BA
EUCLIDES DA CUNHA	BA
FATIMA	BA
FEIRA DE SANTANA	BA
GAVIAO	BA
GLORIA	BA
GOVERNADOR MANGABEIRA	BA
HELIOPOLIS	BA
IACU	BA
IBIQUERA	BA
ICHU	BA
INHAMBUPE	BA
IPECAETA	BA
IPIRA	BA
IRAQUARA	BA
IRARA	BA
ITABERABA	BA
ITAETE	BA
ITANAGRA	BA
ITAPICURU	BA
ITATIM	BA
JAGUARIPE	BA
JANDAIRA	BA
JEREMOABO	BA
JIQUIRICA	BA
LAJE	BA
LAJEDINHO	BA
LAMARAO	BA
LENCOIS	BA
MACURURE	BA
MARAGOGIPE	BA
MARCIONILIO SOUZA	BA
MILAGRES	BA
MONTE SANTO	BA
MUCUGE	BA
MUNIZ FERREIRA	BA
MURITIBA	BA
MUTUIPE	BA
NAZARE	BA
NORDESTINA	BA
NOVA FATIMA	BA
NOVA REDENCAO	BA
NOVA SOURE	BA
NOVO TRIUNFO	BA
OLINDINA	BA
OURICANGAS	BA
PALMEIRAS	BA
PARIPIRANGA	BA
PAULO AFONSO	BA
PE DE SERRA	BA
PEDRAO	BA
PEDRO ALEXANDRE	BA
PINTADAS	BA
QUEIMADAS	BA
QUIJINGUE	BA
RAFAEL JAMBEIRO	BA
RETIROLANDIA	BA
RIACHAO DO JACUIPE	BA
RIBEIRA DO AMPARO	BA
RIBEIRA DO POMBAL	BA
RIO REAL	BA
RODELAS	BA
RUY BARBOSA	BA
SALINAS DA MARGARIDA	BA
SANTA BARBARA	BA
SANTA BRIGIDA	BA
SANTA TERESINHA	BA
SANTALUZ	BA
SANTANOPOLIS	BA
SANTO AMARO	BA
SANTO ANTONIO DE JESUS	BA
SANTO ESTEVAO	BA
SAO DOMINGOS	BA
SAO FELIPE	BA
SAO FELIX	BA
SAO GONCALO DOS CAMPOS	BA
SAO MIGUEL DAS MATAS	BA
SAPEACU	BA
SATIRO DIAS	BA
SAUBARA	BA
SEABRA	BA
SERRA PRETA	BA
SERRINHA	BA
SITIO DO QUINTO	BA
SOUTO SOARES	BA
TANQUINHO	BA
TAPEROA	BA
TEODORO SAMPAIO	BA
TEOFILANDIA	BA
TERRA NOVA	BA
TUCANO	BA
UBAIRA	BA
UTINGA	BA
VALENCA	BA
VALENTE	BA
VARZEDO	BA
WAGNER	BA
DDD 77
ABAIRA	BA
ANAGE	BA
ANGICAL	BA
ARACATU	BA
BAIANOPOLIS	BA
BARRA DA ESTIVA	BA
BARRA DO CHOCA	BA
BARREIRAS	BA
BELO CAMPO	BA
BOA NOVA	BA
BOM JESUS DA LAPA	BA
BOM JESUS DA SERRA	BA
BOQUIRA	BA
BOTUPORA	BA
BREJOLANDIA	BA
BROTAS DE MACAUBAS	BA
BRUMADO	BA
BURITIRAMA	BA
CAATIBA	BA
CACULE	BA
CAETANOS	BA
CAETITE	BA
CANAPOLIS	BA
CANDIBA	BA
CANDIDO SALES	BA
CARAIBAS	BA
CARINHANHA	BA
CATOLANDIA	BA
CATURAMA	BA
COCOS	BA
CONDEUBA	BA
CONTENDAS DO SINCORA	BA
CORDEIROS	BA
CORIBE	BA
CORRENTINA	BA
COTEGIPE	BA
CRISTOPOLIS	BA
DOM BASILIO	BA
ENCRUZILHADA	BA
ERICO CARDOSO	BA
FEIRA DA MATA	BA
FORMOSA DO RIO PRETO	BA
GUAJERU	BA
GUANAMBI	BA
IBIASSUCE	BA
IBICOARA	BA
IBIPITANGA	BA
IBITIARA	BA
IBOTIRAMA	BA
IGAPORA	BA
IPUPIARA	BA
IRAMAIA	BA
ITAMBE	BA
ITAPETINGA	BA
ITUACU	BA
IUIU	BA
JABORANDI	BA
JACARACI	BA
JUSSIAPE	BA
LAGOA REAL	BA
LICINIO DE ALMEIDA	BA
LIVRAMENTO DE NOSSA SENHORA	BA
LUIS EDUARDO MAGALHAES	BA
MACARANI	BA
MACAUBAS	BA
MAETINGA	BA
MAIQUINIQUE	BA
MALHADA	BA
MALHADA DE PEDRAS	BA
MANSIDAO	BA
MATINA	BA
MIRANTE	BA
MORPARA	BA
MORTUGABA	BA
MUQUEM DE SAO FRANCISCO	BA
NOVO HORIZONTE	BA
OLIVEIRA DOS BREJINHOS	BA
PALMAS DE MONTE ALTO	BA
PARAMIRIM	BA
PARATINGA	BA
PIATA	BA
PINDAI	BA
PIRIPA	BA
PLANALTO	BA
POCOES	BA
PRESIDENTE JANIO QUADROS	BA
RIACHAO DAS NEVES	BA
RIACHO DE SANTANA	BA
RIBEIRAO DO LARGO	BA
RIO DE CONTAS	BA
RIO DO ANTONIO	BA
RIO DO PIRES	BA
SANTA MARIA DA VITORIA	BA
SANTA RITA DE CASSIA	BA
SANTANA	BA
SAO DESIDERIO	BA
SEBASTIAO LARANJEIRAS	BA
SERRA DO RAMALHO	BA
SERRA DOURADA	BA
SITIO DO MATO	BA
TABOCAS DO BREJO VELHO	BA
TANHACU	BA
TANQUE NOVO	BA
TREMEDAL	BA
URANDI	BA
VITORIA DA CONQUISTA	BA
WANDERLEY	BA
DDD 79
AMPARO DE SAO FRANCISCO	SE
AQUIDABA	SE
ARACAJU	SE
ARAUA	SE
AREIA BRANCA	SE
BARRA DOS COQUEIROS	SE
BOQUIM	SE
BREJO GRANDE	SE
CAMPO DO BRITO	SE
CANHOBA	SE
CANINDE DE SAO FRANCISCO	SE
CAPELA	SE
CARIRA	SE
CARMOPOLIS	SE
CEDRO DE SAO JOAO	SE
CRISTINAPOLIS	SE
CUMBE	SE
DIVINA PASTORA	SE
ESTANCIA	SE
FEIRA NOVA	SE
FREI PAULO	SE
GARARU	SE
GENERAL MAYNARD	SE
GRACHO CARDOSO	SE
ILHA DAS FLORES	SE
INDIAROBA	SE
ITABAIANA	SE
ITABAIANINHA	SE
ITABI	SE
ITAPORANGA D'AJUDA	SE
JAPARATUBA	SE
JAPOATA	SE
LAGARTO	SE
LARANJEIRAS	SE
MALHADA DOS BOIS	SE
MALHADOR	SE
MARUIM	SE
MOITA BONITA	SE
MONTE ALEGRE DE SERGIPE	SE
MURIBECA	SE
NEOPOLIS	SE
NOSSA SENHORA APARECIDA	SE
NOSSA SENHORA DA GLORIA	SE
NOSSA SENHORA DAS DORES	SE
NOSSA SENHORA DE LOURDES	SE
NOSSA SENHORA DO SOCORRO	SE
PACATUBA	SE
PEDRA MOLE	SE
PEDRINHAS	SE
PINHAO	SE
PIRAMBU	SE
POCO REDONDO	SE
POCO VERDE	SE
PORTO DA FOLHA	SE
PROPRIA	SE
RIACHAO DO DANTAS	SE
RIACHUELO	SE
RIBEIROPOLIS	SE
ROSARIO DO CATETE	SE
SALGADO	SE
SANTA LUZIA DO ITANHY	SE
SANTA ROSA DE LIMA	SE
SANTANA DO SAO FRANCISCO	SE
SANTO AMARO DAS BROTAS	SE
SAO CRISTOVAO	SE
SAO DOMINGOS	SE
SAO FRANCISCO	SE
SAO MIGUEL DO ALEIXO	SE
SIMAO DIAS	SE
SIRIRI	SE
TELHA	SE
TOBIAS BARRETO	SE
TOMAR DO GERU	SE
UMBAUBA	SE
DDD 81
ABREU E LIMA	PE
AGRESTINA	PE
AGUA PRETA	PE
ALIANCA	PE
ALTINHO	PE
AMARAJI	PE
ARACOIABA	PE
BARRA DE GUABIRABA	PE
BARREIROS	PE
BELEM DE MARIA	PE
BELO JARDIM	PE
BEZERROS	PE
BOM JARDIM	PE
BONITO	PE
BREJO DA MADRE DE DEUS	PE
BUENOS AIRES	PE
CABO DE SANTO AGOSTINHO	PE
CACHOEIRINHA	PE
CAMARAGIBE	PE
CAMOCIM DE SAO FELIX	PE
CAMUTANGA	PE
CARPINA	PE
CARUARU	PE
CASINHAS	PE
CATENDE	PE
CHA GRANDE	PE
CONDADO	PE
CORTES	PE
CUMARU	PE
CUPIRA	PE
ESCADA	PE
FEIRA NOVA	PE
FERNANDO DE NORONHA	PE
FERREIROS	PE
FREI MIGUELINHO	PE
GAMELEIRA	PE
GLORIA DO GOITA	PE
GOIANA	PE
GRAVATA	PE
IGARASSU	PE
ILHA DE ITAMARACA	PE
IPOJUCA	PE
ITAMBE	PE
ITAPISSUMA	PE
ITAQUITINGA	PE
JABOATAO DOS GUARARAPES	PE
JAQUEIRA	PE
JATAUBA	PE
JOAO ALFREDO	PE
JOAQUIM NABUCO	PE
LAGOA DO CARRO	PE
LAGOA DO ITAENGA	PE
LAGOA DOS GATOS	PE
LIMOEIRO	PE
MACAPARANA	PE
MACHADOS	PE
MARAIAL	PE
MORENO	PE
NAZARE DA MATA	PE
OLINDA	PE
OROBO	PE
PALMARES	PE
PANELAS	PE
PASSIRA	PE
PAUDALHO	PE
PAULISTA	PE
POMBOS	PE
PRIMAVERA	PE
QUIPAPA	PE
RECIFE	PE
RIACHO DAS ALMAS	PE
RIBEIRAO	PE
RIO FORMOSO	PE
SAIRE	PE
SALGADINHO	PE
SANTA CRUZ DO CAPIBARIBE	PE
SANTA MARIA DO CAMBUCA	PE
SAO BENEDITO DO SUL	PE
SAO BENTO DO UNA	PE
SAO CAITANO	PE
SAO JOAQUIM DO MONTE	PE
SAO JOSE DA COROA GRANDE	PE
SAO LOURENCO DA MATA	PE
SAO VICENTE FERRER	PE
SIRINHAEM	PE
SURUBIM	PE
TACAIMBO	PE
TAMANDARE	PE
TAQUARITINGA DO NORTE	PE
TIMBAUBA	PE
TORITAMA	PE
TRACUNHAEM	PE
VERTENTE DO LERIO	PE
VERTENTES	PE
VICENCIA	PE
VITORIA DE SANTO ANTAO	PE
XEXEU	PE
DDD 82
AGUA BRANCA	AL
ANADIA	AL
ARAPIRACA	AL
ATALAIA	AL
BARRA DE SANTO ANTONIO	AL
BARRA DE SAO MIGUEL	AL
BATALHA	AL
BELEM	AL
BELO MONTE	AL
BOCA DA MATA	AL
BRANQUINHA	AL
CACIMBINHAS	AL
CAJUEIRO	AL
CAMPESTRE	AL
CAMPO ALEGRE	AL
CAMPO GRANDE	AL
CANAPI	AL
CAPELA	AL
CARNEIROS	AL
CHA PRETA	AL
COITE DO NOIA	AL
COLONIA LEOPOLDINA	AL
COQUEIRO SECO	AL
CORURIPE	AL
CRAIBAS	AL
DELMIRO GOUVEIA	AL
DOIS RIACHOS	AL
ESTRELA DE ALAGOAS	AL
FEIRA GRANDE	AL
FELIZ DESERTO	AL
FLEXEIRAS	AL
GIRAU DO PONCIANO	AL
IBATEGUARA	AL
IGACI	AL
IGREJA NOVA	AL
INHAPI	AL
JACARE DOS HOMENS	AL
JACUIPE	AL
JAPARATINGA	AL
JARAMATAIA	AL
JEQUIA DA PRAIA	AL
JOAQUIM GOMES	AL
JUNDIA	AL
JUNQUEIRO	AL
LAGOA DA CANOA	AL
LIMOEIRO DE ANADIA	AL
MACEIO	AL
MAJOR ISIDORO	AL
MAR VERMELHO	AL
MARAGOGI	AL
MARAVILHA	AL
MARECHAL DEODORO	AL
MARIBONDO	AL
MATA GRANDE	AL
MATRIZ DE CAMARAGIBE	AL
MESSIAS	AL
MINADOR DO NEGRAO	AL
MONTEIROPOLIS	AL
MURICI	AL
NOVO LINO	AL
OLHO D'AGUA DAS FLORES	AL
OLHO D'AGUA DO CASADO	AL
OLHO D'AGUA GRANDE	AL
OLIVENCA	AL
OURO BRANCO	AL
PALESTINA	AL
PALMEIRA DOS INDIOS	AL
PAO DE ACUCAR	AL
PARICONHA	AL
PARIPUEIRA	AL
PASSO DE CAMARAGIBE	AL
PAULO JACINTO	AL
PENEDO	AL
PIACABUCU	AL
PILAR	AL
PINDOBA	AL
PIRANHAS	AL
POCO DAS TRINCHEIRAS	AL
PORTO CALVO	AL
PORTO DE PEDRAS	AL
PORTO REAL DO COLEGIO	AL
QUEBRANGULO	AL
RIO LARGO	AL
ROTEIRO	AL
SANTA LUZIA DO NORTE	AL
SANTANA DO IPANEMA	AL
SANTANA DO MUNDAU	AL
SAO BRAS	AL
SAO JOSE DA LAJE	AL
SAO JOSE DA TAPERA	AL
SAO LUIS DO QUITUNDE	AL
SAO MIGUEL DOS CAMPOS	AL
SAO MIGUEL DOS MILAGRES	AL
SAO SEBASTIAO	AL
SATUBA	AL
SENADOR RUI PALMEIRA	AL
TANQUE D'ARCA	AL
TAQUARANA	AL
TEOTONIO VILELA	AL
TRAIPU	AL
UNIAO DOS PALMARES	AL
VICOSA	AL
DDD 83
AGUA BRANCA	PB
AGUIAR	PB
ALAGOA GRANDE	PB
ALAGOA NOVA	PB
ALAGOINHA	PB
ALCANTIL	PB
ALGODAO DE JANDAIRA	PB
ALHANDRA	PB
AMPARO	PB
APARECIDA	PB
ARACAGI	PB
ARARA	PB
ARARUNA	PB
AREIA	PB
AREIA DE BARAUNAS	PB
AREIAL	PB
AROEIRAS	PB
ASSUNCAO	PB
BAIA DA TRAICAO	PB
BANANEIRAS	PB
BARAUNA	PB
BARRA DE SANTA ROSA	PB
BARRA DE SANTANA	PB
BARRA DE SAO MIGUEL	PB
BAYEUX	PB
BELEM	PB
BELEM DO BREJO DO CRUZ	PB
BERNARDINO BATISTA	PB
BOA VENTURA	PB
BOM JESUS	PB
BOM SUCESSO	PB
BONITO DE SANTA FE	PB
BOQUEIRAO	PB
BORBOREMA	PB
BREJO DO CRUZ	PB
BREJO DOS SANTOS	PB
CAAPORA	PB
CABACEIRAS	PB
CABEDELO	PB
CACHOEIRA DOS INDIOS	PB
CACIMBA DE AREIA	PB
CACIMBA DE DENTRO	PB
CACIMBAS	PB
CAICARA	PB
CAJAZEIRAS	PB
CAJAZEIRINHAS	PB
CALDAS BRANDAO	PB
CAMALAU	PB
CAMPINA GRANDE	PB
CAMPO DE SANTANA	PB
CAPIM	PB
CARAUBAS	PB
CARRAPATEIRA	PB
CASSERENGUE	PB
CATINGUEIRA	PB
CATOLE DO ROCHA	PB
CATURITE	PB
CONCEICAO	PB
CONDADO	PB
CONDE	PB
CONGO	PB
COREMAS	PB
COXIXOLA	PB
CRUZ DO ESPIRITO SANTO	PB
CUBATI	PB
CUITE	PB
CUITE DE MAMANGUAPE	PB
CUITEGI	PB
CURRAL DE CIMA	PB
CURRAL VELHO	PB
DAMIAO	PB
DESTERRO	PB
DIAMANTE	PB
DONA INES	PB
DUAS ESTRADAS	PB
EMAS	PB
ESPERANCA	PB
FAGUNDES	PB
FREI MARTINHO	PB
GADO BRAVO	PB
GUARABIRA	PB
GURINHEM	PB
GURJAO	PB
IBIARA	PB
IGARACY	PB
IMACULADA	PB
INGA	PB
ITABAIANA	PB
ITAPORANGA	PB
ITAPOROROCA	PB
ITATUBA	PB
JACARAU	PB
JERICO	PB
JOAO PESSOA	PB
JUAREZ TAVORA	PB
JUAZEIRINHO	PB
JUNCO DO SERIDO	PB
JURIPIRANGA	PB
JURU	PB
LAGOA	PB
LAGOA DE DENTRO	PB
LAGOA SECA	PB
LASTRO	PB
LIVRAMENTO	PB
LOGRADOURO	PB
LUCENA	PB
MAE D'AGUA	PB
MALTA	PB
MAMANGUAPE	PB
MANAIRA	PB
MARCACAO	PB
MARI	PB
MARIZOPOLIS	PB
MASSARANDUBA	PB
MATARACA	PB
MATINHAS	PB
MATO GROSSO	PB
MATUREIA	PB
MOGEIRO	PB
MONTADAS	PB
MONTE HOREBE	PB
MONTEIRO	PB
MULUNGU	PB
NATUBA	PB
NAZAREZINHO	PB
NOVA FLORESTA	PB
NOVA OLINDA	PB
NOVA PALMEIRA	PB
OLHO D'AGUA	PB
OLIVEDOS	PB
OURO VELHO	PB
PARARI	PB
PASSAGEM	PB
PATOS	PB
PAULISTA	PB
PEDRA BRANCA	PB
PEDRA LAVRADA	PB
PEDRAS DE FOGO	PB
PEDRO REGIS	PB
PIANCO	PB
PICUI	PB
PILAR	PB
PILOES	PB
PILOEZINHOS	PB
PIRPIRITUBA	PB
PITIMBU	PB
POCINHOS	PB
POCO DANTAS	PB
POCO DE JOSE DE MOURA	PB
POMBAL	PB
PRATA	PB
PRINCESA ISABEL	PB
PUXINANA	PB
QUEIMADAS	PB
QUIXABA	PB
REMIGIO	PB
RIACHAO	PB
RIACHAO DO BACAMARTE	PB
RIACHAO DO POCO	PB
RIACHO DE SANTO ANTONIO	PB
RIACHO DOS CAVALOS	PB
RIO TINTO	PB
SALGADINHO	PB
SALGADO DE SAO FELIX	PB
SANTA CECILIA	PB
SANTA CRUZ	PB
SANTA HELENA	PB
SANTA INES	PB
SANTA LUZIA	PB
SANTA RITA	PB
SANTA TERESINHA	PB
SANTANA DE MANGUEIRA	PB
SANTANA DOS GARROTES	PB
SANTAREM	PB
SANTO ANDRE	PB
SAO BENTINHO	PB
SAO BENTO	PB
SAO DOMINGOS DE POMBAL	PB
SAO DOMINGOS DO CARIRI	PB
SAO FRANCISCO	PB
SAO JOAO DO CARIRI	PB
SAO JOAO DO RIO DO PEIXE	PB
SAO JOAO DO TIGRE	PB
SAO JOSE DA LAGOA TAPADA	PB
SAO JOSE DE CAIANA	PB
SAO JOSE DE ESPINHARAS	PB
SAO JOSE DE PIRANHAS	PB
SAO JOSE DE PRINCESA	PB
SAO JOSE DO BONFIM	PB
SAO JOSE DO BREJO DO CRUZ	PB
SAO JOSE DO SABUGI	PB
SAO JOSE DOS CORDEIROS	PB
SAO JOSE DOS RAMOS	PB
SAO MAMEDE	PB
SAO MIGUEL DE TAIPU	PB
SAO SEBASTIAO DE LAGOA DE ROCA	PB
SAO SEBASTIAO DO UMBUZEIRO	PB
SAPE	PB
SERIDO	PB
SERRA BRANCA	PB
SERRA DA RAIZ	PB
SERRA GRANDE	PB
SERRA REDONDA	PB
SERRARIA	PB
SERTAOZINHO	PB
SOBRADO	PB
SOLANEA	PB
SOLEDADE	PB
SOSSEGO	PB
SOUSA	PB
SUME	PB
TAPEROA	PB
TAVARES	PB
TEIXEIRA	PB
TENORIO	PB
TRIUNFO	PB
UIRAUNA	PB
UMBUZEIRO	PB
VARZEA	PB
VIEIROPOLIS	PB
VISTA SERRANA	PB
ZABELE	PB
DDD 84
ACARI	RN
ACU	RN
AFONSO BEZERRA	RN
AGUA NOVA	RN
ALEXANDRIA	RN
ALMINO AFONSO	RN
ALTO DO RODRIGUES	RN
ANGICOS	RN
ANTONIO MARTINS	RN
APODI	RN
AREIA BRANCA	RN
ARES	RN
AUGUSTO SEVERO	RN
BAIA FORMOSA	RN
BARAUNA	RN
BARCELONA	RN
BENTO FERNANDES	RN
BODO	RN
BOM JESUS	RN
BREJINHO	RN
CAICARA DO NORTE	RN
CAICARA DO RIO DO VENTO	RN
CAICO	RN
CAMPO REDONDO	RN
CANGUARETAMA	RN
CARAUBAS	RN
CARNAUBA DOS DANTAS	RN
CARNAUBAIS	RN
CEARA-MIRIM	RN
CERRO CORA	RN
CORONEL EZEQUIEL	RN
CORONEL JOAO PESSOA	RN
CRUZETA	RN
CURRAIS NOVOS	RN
DOUTOR SEVERIANO	RN
ENCANTO	RN
EQUADOR	RN
ESPIRITO SANTO	RN
EXTREMOZ	RN
FELIPE GUERRA	RN
FERNANDO PEDROZA	RN
FLORANIA	RN
FRANCISCO DANTAS	RN
FRUTUOSO GOMES	RN
GALINHOS	RN
GOIANINHA	RN
GOVERNADOR DIX-SEPT ROSADO	RN
GROSSOS	RN
GUAMARE	RN
IELMO MARINHO	RN
IPANGUACU	RN
IPUEIRA	RN
ITAJA	RN
ITAU	RN
JACANA	RN
JANDAIRA	RN
JANDUIS	RN
JANUARIO CICCO	RN
JAPI	RN
JARDIM DE ANGICOS	RN
JARDIM DE PIRANHAS	RN
JARDIM DO SERIDO	RN
JOAO CAMARA	RN
JOAO DIAS	RN
JOSE DA PENHA	RN
JUCURUTU	RN
JUNDIA	RN
LAGOA D'ANTA	RN
LAGOA DE PEDRAS	RN
LAGOA DE VELHOS	RN
LAGOA NOVA	RN
LAGOA SALGADA	RN
LAJES	RN
LAJES PINTADAS	RN
LUCRECIA	RN
LUIS GOMES	RN
MACAIBA	RN
MACAU	RN
MAJOR SALES	RN
MARCELINO VIEIRA	RN
MARTINS	RN
MAXARANGUAPE	RN
MESSIAS TARGINO	RN
MONTANHAS	RN
MONTE ALEGRE	RN
MONTE DAS GAMELEIRAS	RN
MOSSORO	RN
NATAL	RN
NISIA FLORESTA	RN
NOVA CRUZ	RN
OLHO-D'AGUA DO BORGES	RN
OURO BRANCO	RN
PARANA	RN
PARAU	RN
PARAZINHO	RN
PARELHAS	RN
PARNAMIRIM	RN
PASSA E FICA	RN
PASSAGEM	RN
PATU	RN
PAU DOS FERROS	RN
PEDRA GRANDE	RN
PEDRA PRETA	RN
PEDRO AVELINO	RN
PEDRO VELHO	RN
PENDENCIAS	RN
PILOES	RN
POCO BRANCO	RN
PORTALEGRE	RN
PORTO DO MANGUE	RN
PRESIDENTE JUSCELINO	RN
PUREZA	RN
RAFAEL FERNANDES	RN
RAFAEL GODEIRO	RN
RIACHO DA CRUZ	RN
RIACHO DE SANTANA	RN
RIACHUELO	RN
RIO DO FOGO	RN
RODOLFO FERNANDES	RN
RUY BARBOSA	RN
SANTA CRUZ	RN
SANTA MARIA	RN
SANTANA DO MATOS	RN
SANTANA DO SERIDO	RN
SANTO ANTONIO	RN
SAO BENTO DO NORTE	RN
SAO BENTO DO TRAIRI	RN
SAO FERNANDO	RN
SAO FRANCISCO DO OESTE	RN
SAO GONCALO DO AMARANTE	RN
SAO JOAO DO SABUGI	RN
SAO JOSE DE MIPIBU	RN
SAO JOSE DO CAMPESTRE	RN
SAO JOSE DO SERIDO	RN
SAO MIGUEL	RN
SAO MIGUEL DE TOUROS	RN
SAO PAULO DO POTENGI	RN
SAO PEDRO	RN
SAO RAFAEL	RN
SAO TOME	RN
SAO VICENTE	RN
SENADOR ELOI DE SOUZA	RN
SENADOR GEORGINO AVELINO	RN
SERRA DE SAO BENTO	RN
SERRA DO MEL	RN
SERRA NEGRA DO NORTE	RN
SERRINHA	RN
SERRINHA DOS PINTOS	RN
SEVERIANO MELO	RN
SITIO NOVO	RN
TABOLEIRO GRANDE	RN
TAIPU	RN
TANGARA	RN
TENENTE ANANIAS	RN
TENENTE LAURENTINO CRUZ	RN
TIBAU	RN
TIBAU DO SUL	RN
TIMBAUBA DOS BATISTAS	RN
TOUROS	RN
TRIUNFO POTIGUAR	RN
UMARIZAL	RN
UPANEMA	RN
VARZEA	RN
VENHA-VER	RN
VERA CRUZ	RN
VICOSA	RN
VILA FLOR	RN
DDD 85
ACARAPE	CE
APUIARES	CE
AQUIRAZ	CE
ARACOIABA	CE
ARATUBA	CE
BARREIRA	CE
BATURITE	CE
BEBERIBE	CE
CANINDE	CE
CAPISTRANO	CE
CARIDADE	CE
CASCAVEL	CE
CAUCAIA	CE
CHOROZINHO	CE
EUSEBIO	CE
FORTALEZA	CE
GENERAL SAMPAIO	CE
GUAIUBA	CE
GUARAMIRANGA	CE
HORIZONTE	CE
ITAITINGA	CE
ITAPAGE	CE
MARACANAU	CE
MARANGUAPE	CE
MULUNGU	CE
OCARA	CE
PACAJUS	CE
PACATUBA	CE
PACOTI	CE
PALMACIA	CE
PARACURU	CE
PARAIPABA	CE
PARAMOTI	CE
PENTECOSTE	CE
PINDORETAMA	CE
REDENCAO	CE
SAO GONCALO DO AMARANTE	CE
SAO LUIS DO CURU	CE
TEJUCUOCA	CE
TRAIRI	CE
TURURU	CE
UMIRIM	CE
URUBURETAMA	CE
DDD 86
AGRICOLANDIA	PI
AGUA BRANCA	PI
ALTO LONGA	PI
ALTOS	PI
AMARANTE	PI
ANGICAL DO PIAUI	PI
ASSUNCAO DO PIAUI	PI
BARRAS	PI
BARRO DURO	PI
BATALHA	PI
BENEDITINOS	PI
BOA HORA	PI
BOM PRINCIPIO DO PIAUI	PI
BOQUEIRAO DO PIAUI	PI
BRASILEIRA	PI
BURITI DOS LOPES	PI
BURITI DOS MONTES	PI
CABECEIRAS DO PIAUI	PI
CAJUEIRO DA PRAIA	PI
CAMPO LARGO DO PIAUI	PI
CAMPO MAIOR	PI
CAPITAO DE CAMPOS	PI
CARAUBAS DO PIAUI	PI
CASTELO DO PIAUI	PI
CAXINGO	PI
COCAL	PI
COCAL DE TELHA	PI
COCAL DOS ALVES	PI
COIVARAS	PI
CURRALINHOS	PI
DEMERVAL LOBAO	PI
DOMINGOS MOURAO	PI
ELESBAO VELOSO	PI
ESPERANTINA	PI
HUGO NAPOLEAO	PI
JARDIM DO MULATO	PI
JATOBA DO PIAUI	PI
JOAQUIM PIRES	PI
JOCA MARQUES	PI
JOSE DE FREITAS	PI
JUAZEIRO DO PIAUI	PI
LAGOA ALEGRE	PI
LAGOA DE SAO FRANCISCO	PI
LAGOA DO PIAUI	PI
LAGOINHA DO PIAUI	PI
LUIS CORREIA	PI
LUZILANDIA	PI
MADEIRO	PI
MATIAS OLIMPIO	PI
MIGUEL ALVES	PI
MIGUEL LEAO	PI
MILTON BRANDAO	PI
MONSENHOR GIL	PI
MORRO DO CHAPEU DO PIAUI	PI
MURICI DOS PORTELAS	PI
NOSSA SENHORA DE NAZARE	PI
NOSSA SENHORA DOS REMEDIOS	PI
NOVO SANTO ANTONIO	PI
OLHO D'AGUA DO PIAUI	PI
PALMEIRAIS	PI
PARNAIBA	PI
PASSAGEM FRANCA DO PIAUI	PI
PAU D'ARCO DO PIAUI	PI
PEDRO II	PI
PIRACURUCA	PI
PIRIPIRI	PI
PORTO	PI
PRATA DO PIAUI	PI
REGENERACAO	PI
SANTO ANTONIO DOS MILAGRES	PI
SAO FELIX DO PIAUI	PI
SAO GONCALO DO PIAUI	PI
SAO JOAO DA FRONTEIRA	PI
SAO JOAO DA SERRA	PI
SAO JOAO DO ARRAIAL	PI
SAO JOSE DO DIVINO	PI
SAO MIGUEL DA BAIXA GRANDE	PI
SAO MIGUEL DO TAPUIO	PI
SAO PEDRO DO PIAUI	PI
SIGEFREDO PACHECO	PI
TERESINA	PI
UNIAO	PI
DDD 87
AFOGADOS DA INGAZEIRA	PE
AFRANIO	PE
AGUAS BELAS	PE
ALAGOINHA	PE
ANGELIM	PE
ARARIPINA	PE
ARCOVERDE	PE
BELEM DE SAO FRANCISCO	PE
BETANIA	PE
BODOCO	PE
BOM CONSELHO	PE
BREJAO	PE
BREJINHO	PE
BUIQUE	PE
CABROBO	PE
CAETES	PE
CALCADO	PE
CALUMBI	PE
CANHOTINHO	PE
CAPOEIRAS	PE
CARNAIBA	PE
CARNAUBEIRA DA PENHA	PE
CEDRO	PE
CORRENTES	PE
CUSTODIA	PE
DORMENTES	PE
EXU	PE
FLORES	PE
FLORESTA	PE
GARANHUNS	PE
GRANITO	PE
IATI	PE
IBIMIRIM	PE
IBIRAJUBA	PE
IGUARACI	PE
INAJA	PE
INGAZEIRA	PE
IPUBI	PE
ITACURUBA	PE
ITAIBA	PE
ITAPETIM	PE
JATOBA	PE
JUCATI	PE
JUPI	PE
JUREMA	PE
LAGOA DO OURO	PE
LAGOA GRANDE	PE
LAJEDO	PE
MANARI	PE
MIRANDIBA	PE
MOREILANDIA	PE
OROCO	PE
OURICURI	PE
PALMEIRINA	PE
PARANATAMA	PE
PARNAMIRIM	PE
PEDRA	PE
PESQUEIRA	PE
PETROLANDIA	PE
PETROLINA	PE
POCAO	PE
QUIXABA	PE
SALGUEIRO	PE
SALOA	PE
SANHARO	PE
SANTA CRUZ	PE
SANTA CRUZ DA BAIXA VERDE	PE
SANTA FILOMENA	PE
SANTA MARIA DA BOA VISTA	PE
SANTA TEREZINHA	PE
SAO JOAO	PE
SAO JOSE DO BELMONTE	PE
SAO JOSE DO EGITO	PE
SERRA TALHADA	PE
SERRITA	PE
SERTANIA	PE
SOLIDAO	PE
TABIRA	PE
TACARATU	PE
TEREZINHA	PE
TERRA NOVA	PE
TRINDADE	PE
TRIUNFO	PE
TUPANATINGA	PE
TUPARETAMA	PE
VENTUROSA	PE
VERDEJANTE	PE
DDD 88
ABAIARA	CE
ACARAU	CE
ACOPIARA	CE
AIUABA	CE
ALCANTARAS	CE
ALTANEIRA	CE
ALTO SANTO	CE
AMONTADA	CE
ANTONINA DO NORTE	CE
ARACATI	CE
ARARENDA	CE
ARARIPE	CE
ARNEIROZ	CE
ASSARE	CE
AURORA	CE
BAIXIO	CE
BANABUIU	CE
BARBALHA	CE
BARRO	CE
BARROQUINHA	CE
BELA CRUZ	CE
BOA VIAGEM	CE
BREJO SANTO	CE
CAMOCIM	CE
CAMPOS SALES	CE
CARIRE	CE
CARIRIACU	CE
CARIUS	CE
CARNAUBAL	CE
CATARINA	CE
CATUNDA	CE
CEDRO	CE
CHAVAL	CE
CHORO	CE
COREAU	CE
CRATEUS	CE
CRATO	CE
CROATA	CE
CRUZ	CE
DEPUTADO IRAPUAN PINHEIRO	CE
ERERE	CE
FARIAS BRITO	CE
FORQUILHA	CE
FORTIM	CE
FRECHEIRINHA	CE
GRACA	CE
GRANJA	CE
GRANJEIRO	CE
GROAIRAS	CE
GUARACIABA DO NORTE	CE
HIDROLANDIA	CE
IBARETAMA	CE
IBIAPINA	CE
IBICUITINGA	CE
ICAPUI	CE
ICO	CE
IGUATU	CE
INDEPENDENCIA	CE
IPAPORANGA	CE
IPAUMIRIM	CE
IPU	CE
IPUEIRAS	CE
IRACEMA	CE
IRAUCUBA	CE
ITAICABA	CE
ITAPIPOCA	CE
ITAPIUNA	CE
ITAREMA	CE
ITATIRA	CE
JAGUARETAMA	CE
JAGUARIBARA	CE
JAGUARIBE	CE
JAGUARUANA	CE
JARDIM	CE
JATI	CE
JIJOCA DE JERICOACOARA	CE
JUAZEIRO DO NORTE	CE
JUCAS	CE
LAVRAS DA MANGABEIRA	CE
LIMOEIRO DO NORTE	CE
MADALENA	CE
MARCO	CE
MARTINOPOLE	CE
MASSAPE	CE
MAURITI	CE
MERUOCA	CE
MILAGRES	CE
MILHA	CE
MIRAIMA	CE
MISSAO VELHA	CE
MOMBACA	CE
MONSENHOR TABOSA	CE
MORADA NOVA	CE
MORAUJO	CE
MORRINHOS	CE
MUCAMBO	CE
NOVA OLINDA	CE
NOVA RUSSAS	CE
NOVO ORIENTE	CE
OROS	CE
PACUJA	CE
PALHANO	CE
PARAMBU	CE
PEDRA BRANCA	CE
PENAFORTE	CE
PEREIRO	CE
PIQUET CARNEIRO	CE
PIRES FERREIRA	CE
PORANGA	CE
PORTEIRAS	CE
POTENGI	CE
POTIRETAMA	CE
QUITERIANOPOLIS	CE
QUIXADA	CE
QUIXELO	CE
QUIXERAMOBIM	CE
QUIXERE	CE
RERIUTABA	CE
RUSSAS	CE
SABOEIRO	CE
SALITRE	CE
SANTA QUITERIA	CE
SANTANA DO ACARAU	CE
SANTANA DO CARIRI	CE
SAO BENEDITO	CE
SAO JOAO DO JAGUARIBE	CE
SENADOR POMPEU	CE
SENADOR SA	CE
SOBRAL	CE
SOLONOPOLE	CE
TABULEIRO DO NORTE	CE
TAMBORIL	CE
TARRAFAS	CE
TAUA	CE
TIANGUA	CE
UBAJARA	CE
UMARI	CE
URUOCA	CE
VARJOTA	CE
VARZEA ALEGRE	CE
VICOSA DO CEARA	CE
DDD 89
ACAUA	PI
ALAGOINHA DO PIAUI	PI
ALEGRETE DO PIAUI	PI
ALVORADA DO GURGUEIA	PI
ANISIO DE ABREU	PI
ANTONIO ALMEIDA	PI
AROAZES	PI
ARRAIAL	PI
AVELINO LOPES	PI
BAIXA GRANDE DO RIBEIRO	PI
BARRA D'ALCANTARA	PI
BARREIRAS DO PIAUI	PI
BELA VISTA DO PIAUI	PI
BELEM DO PIAUI	PI
BERTOLINIA	PI
BETANIA DO PIAUI	PI
BOCAINA	PI
BOM JESUS	PI
BONFIM DO PIAUI	PI
BREJO DO PIAUI	PI
CAJAZEIRAS DO PIAUI	PI
CALDEIRAO GRANDE DO PIAUI	PI
CAMPINAS DO PIAUI	PI
CAMPO ALEGRE DO FIDALGO	PI
CAMPO GRANDE DO PIAUI	PI
CANAVIEIRA	PI
CANTO DO BURITI	PI
CAPITAO GERVASIO OLIVEIRA	PI
CARACOL	PI
CARIDADE DO PIAUI	PI
COLONIA DO GURGUEIA	PI
COLONIA DO PIAUI	PI
CONCEICAO DO CANINDE	PI
CORONEL JOSE DIAS	PI
CORRENTE	PI
CRISTALANDIA DO PIAUI	PI
CRISTINO CASTRO	PI
CURIMATA	PI
CURRAIS	PI
CURRAL NOVO DO PIAUI	PI
DIRCEU ARCOVERDE	PI
DOM EXPEDITO LOPES	PI
DOM INOCENCIO	PI
ELISEU MARTINS	PI
FARTURA DO PIAUI	PI
FLORES DO PIAUI	PI
FLORESTA DO PIAUI	PI
FLORIANO	PI
FRANCINOPOLIS	PI
FRANCISCO AYRES	PI
FRANCISCO MACEDO	PI
FRANCISCO SANTOS	PI
FRONTEIRAS	PI
GEMINIANO	PI
GILBUES	PI
GUADALUPE	PI
GUARIBAS	PI
INHUMA	PI
IPIRANGA DO PIAUI	PI
ISAIAS COELHO	PI
ITAINOPOLIS	PI
ITAUEIRA	PI
JACOBINA DO PIAUI	PI
JAICOS	PI
JERUMENHA	PI
JOAO COSTA	PI
JULIO BORGES	PI
JUREMA	PI
LAGOA DO BARRO DO PIAUI	PI
LAGOA DO SITIO	PI
LANDRI SALES	PI
MANOEL EMIDIO	PI
MARCOLANDIA	PI
MARCOS PARENTE	PI
MASSAPE DO PIAUI	PI
MONSENHOR HIPOLITO	PI
MONTE ALEGRE DO PIAUI	PI
MORRO CABECA NO TEMPO	PI
NAZARE DO PIAUI	PI
NOVA SANTA RITA	PI
NOVO ORIENTE DO PIAUI	PI
OEIRAS	PI
PADRE MARCOS	PI
PAES LANDIM	PI
PAJEU DO PIAUI	PI
PALMEIRA DO PIAUI	PI
PAQUETA	PI
PARNAGUA	PI
PATOS DO PIAUI	PI
PAULISTANA	PI
PAVUSSU	PI
PEDRO LAURENTINO	PI
PICOS	PI
PIMENTEIRAS	PI
PIO IX	PI
PORTO ALEGRE DO PIAUI	PI
QUEIMADA NOVA	PI
REDENCAO DO GURGUEIA	PI
RIACHO FRIO	PI
RIBEIRA DO PIAUI	PI
RIBEIRO GONCALVES	PI
RIO GRANDE DO PIAUI	PI
SANTA CRUZ DO PIAUI	PI
SANTA CRUZ DOS MILAGRES	PI
SANTA FILOMENA	PI
SANTA LUZ	PI
SANTA ROSA DO PIAUI	PI
SANTANA DO PIAUI	PI
SANTO ANTONIO DE LISBOA	PI
SANTO INACIO DO PIAUI	PI
SAO BRAZ DO PIAUI	PI
SAO FRANCISCO DE ASSIS DO PIAUI	PI
SAO FRANCISCO DO PIAUI	PI
SAO GONCALO DO GURGUEIA	PI
SAO JOAO DA CANABRAVA	PI
SAO JOAO DA VARJOTA	PI
SAO JOAO DO PIAUI	PI
SAO JOSE DO PEIXE	PI
SAO JOSE DO PIAUI	PI
SAO JULIAO	PI
SAO LOURENCO DO PIAUI	PI
SAO LUIS DO PIAUI	PI
SAO MIGUEL DO FIDALGO	PI
SAO RAIMUNDO NONATO	PI
SEBASTIAO BARROS	PI
SEBASTIAO LEAL	PI
SIMOES	PI
SIMPLICIO MENDES	PI
SOCORRO DO PIAUI	PI
SUSSUAPARA	PI
TAMBORIL DO PIAUI	PI
TANQUE DO PIAUI	PI
URUCUI	PI
VALENCA DO PIAUI	PI
VARZEA BRANCA	PI
VARZEA GRANDE	PI
VERA MENDES	PI
VILA NOVA DO PIAUI	PI
WALL FERRAZ	PI
DDD 91
ABAETETUBA	PA
ACARA	PA
AFUA	PA
ANAJAS	PA
ANANINDEUA	PA
ANAPU	PA
AUGUSTO CORREA	PA
AURORA DO PARA	PA
BAGRE	PA
BAIAO	PA
BARCARENA	PA
BELEM	PA
BENEVIDES	PA
BONITO	PA
BRAGANCA	PA
BREVES	PA
BUJARU	PA
CACHOEIRA DO ARARI	PA
CACHOEIRA DO PIRIA	PA
CAMETA	PA
CAPANEMA	PA
CAPITAO POCO	PA
CASTANHAL	PA
CHAVES	PA
COLARES	PA
CONCORDIA DO PARA	PA
CURRALINHO	PA
CURUCA	PA
GARRAFAO DO NORTE	PA
GURUPA	PA
IGARAPE-ACU	PA
IGARAPE-MIRI	PA
INHANGAPI	PA
IPIXUNA DO PARA	PA
IRITUIA	PA
LIMOEIRO DO AJURU	PA
MAE DO RIO	PA
MAGALHAES BARATA	PA
MARACANA	PA
MARAPANIM	PA
MARITUBA	PA
MELGACO	PA
MOCAJUBA	PA
MOJU	PA
MUANA	PA
NOVA ESPERANCA DO PIRIA	PA
NOVA TIMBOTEUA	PA
OEIRAS DO PARA	PA
OUREM	PA
PACAJA	PA
PARAGOMINAS	PA
PEIXE-BOI	PA
PONTA DE PEDRAS	PA
PORTEL	PA
PRIMAVERA	PA
QUATIPURU	PA
SALINOPOLIS	PA
SALVATERRA	PA
SANTA BARBARA DO PARA	PA
SANTA CRUZ DO ARARI	PA
SANTA ISABEL DO PARA	PA
SANTA LUZIA DO PARA	PA
SANTA MARIA DO PARA	PA
SANTAREM NOVO	PA
SANTO ANTONIO DO TAUA	PA
SAO CAETANO DE ODIVELAS	PA
SAO DOMINGOS DO CAPIM	PA
SAO FRANCISCO DO PARA	PA
SAO JOAO DA PONTA	PA
SAO JOAO DE PIRABAS	PA
SAO MIGUEL DO GUAMA	PA
SAO SEBASTIAO DA BOA VISTA	PA
SENADOR JOSE PORFIRIO	PA
SOURE	PA
TAILANDIA	PA
TERRA ALTA	PA
TOME-ACU	PA
TRACUATEUA	PA
ULIANOPOLIS	PA
VIGIA	PA
VISEU	PA
DDD 92
AUTAZES	AM
BARREIRINHA	AM
BOA VISTA DO RAMOS	AM
BORBA	AM
CAAPIRANGA	AM
CAREIRO	AM
CAREIRO DA VARZEA	AM
IRANDUBA	AM
ITACOATIARA	AM
ITAPIRANGA	AM
MANACAPURU	AM
MANAQUIRI	AM
MANAUS	AM
MAUES	AM
NHAMUNDA	AM
NOVA OLINDA DO NORTE	AM
NOVO AIRAO	AM
PARINTINS	AM
PRESIDENTE FIGUEIREDO	AM
RIO PRETO DA EVA	AM
SAO SEBASTIAO DO UATUMA	AM
SILVES	AM
URUCARA	AM
URUCURITUBA	AM
DDD 93
ALENQUER	PA
ALMEIRIM	PA
ALTAMIRA	PA
AVEIRO	PA
BELTERRA	PA
BRASIL NOVO	PA
CURUA	PA
FARO	PA
ITAITUBA	PA
JACAREACANGA	PA
JURUTI	PA
MEDICILANDIA	PA
MONTE ALEGRE	PA
NOVO PROGRESSO	PA
OBIDOS	PA
ORIXIMINA	PA
PLACAS	PA
PORTO DE MOZ	PA
PRAINHA	PA
RUROPOLIS	PA
SANTAREM	PA
TERRA SANTA	PA
TRAIRAO	PA
URUARA	PA
VITORIA DO XINGU	PA
DDD 94
ABEL FIGUEIREDO	PA
AGUA AZUL DO NORTE	PA
BANNACH	PA
BOM JESUS DO TOCANTINS	PA
BREJO GRANDE DO ARAGUAIA	PA
BREU BRANCO	PA
CANAA DOS CARAJAS	PA
CONCEICAO DO ARAGUAIA	PA
CUMARU DO NORTE	PA
CURIONOPOLIS	PA
DOM ELISEU	PA
ELDORADO DOS CARAJAS	PA
FLORESTA DO ARAGUAIA	PA
GOIANESIA DO PARA	PA
ITUPIRANGA	PA
JACUNDA	PA
MARABA	PA
NOVA IPIXUNA	PA
NOVO REPARTIMENTO	PA
OURILANDIA DO NORTE	PA
PALESTINA DO PARA	PA
PARAUAPEBAS	PA
PAU D'ARCO	PA
PICARRA	PA
REDENCAO	PA
RIO MARIA	PA
RONDON DO PARA	PA
SANTA MARIA DAS BARREIRAS	PA
SANTANA DO ARAGUAIA	PA
SAO DOMINGOS DO ARAGUAIA	PA
SAO FELIX DO XINGU	PA
SAO GERALDO DO ARAGUAIA	PA
SAO JOAO DO ARAGUAIA	PA
SAPUCAIA	PA
TUCUMA	PA
TUCURUI	PA
XINGUARA	PA
DDD 95
ALTO ALEGRE	RR
AMAJARI	RR
BOA VISTA	RR
BONFIM	RR
CANTA	RR
CARACARAI	RR
CAROEBE	RR
IRACEMA	RR
MUCAJAI	RR
NORMANDIA	RR
PACARAIMA	RR
RORAINOPOLIS	RR
SAO JOAO DA BALIZA	RR
SAO LUIZ	RR
UIRAMUTA	RR
DDD 96
AMAPA	AP
CALCOENE	AP
CUTIAS	AP
FERREIRA GOMES	AP
ITAUBAL	AP
LARANJAL DO JARI	AP
MACAPA	AP
MAZAGAO	AP
OIAPOQUE	AP
PEDRA BRANCA DO AMAPARI	AP
PORTO GRANDE	AP
PRACUUBA	AP
SANTANA	AP
SERRA DO NAVIO	AP
TARTARUGALZINHO	AP
VITORIA DO JARI	AP
DDD 97
ALVARAES	AM
AMATURA	AM
ANAMA	AM
ANORI	AM
APUI	AM
ATALAIA DO NORTE	AM
BARCELOS	AM
BENJAMIN CONSTANT	AM
BERURI	AM
BOCA DO ACRE	AM
CANUTAMA	AM
CARAUARI	AM
COARI	AM
CODAJAS	AM
EIRUNEPE	AM
ENVIRA	AM
FONTE BOA	AM
GUAJARA	AM
HUMAITA	AM
IPIXUNA	AM
ITAMARATI	AM
JAPURA	AM
JURUA	AM
JUTAI	AM
LABREA	AM
MANICORE	AM
MARAA	AM
NOVO ARIPUANA	AM
PAUINI	AM
SANTA ISABEL DO RIO NEGRO	AM
SANTO ANTONIO DO ICA	AM
SAO GABRIEL DA CACHOEIRA	AM
SAO PAULO DE OLIVENCA	AM
TABATINGA	AM
TAPAUA	AM
TEFE	AM
TONANTINS	AM
UARINI	AM
DDD 98
AFONSO CUNHA	MA
AGUA DOCE DO MARANHAO	MA
ALCANTARA	MA
ALTAMIRA DO MARANHAO	MA
ALTO ALEGRE DO PINDARE	MA
AMAPA DO MARANHAO	MA
ANAJATUBA	MA
ANAPURUS	MA
APICUM-ACU	MA
ARAGUANA	MA
ARAIOSES	MA
ARARI	MA
AXIXA	MA
BACABEIRA	MA
BACURI	MA
BACURITUBA	MA
BARREIRINHAS	MA
BELA VISTA DO MARANHAO	MA
BELAGUA	MA
BEQUIMAO	MA
BOA VISTA DO GURUPI	MA
BOM JARDIM	MA
BOM JESUS DAS SELVAS	MA
BREJO	MA
BREJO DE AREIA	MA
BURITI	MA
BURITICUPU	MA
CACHOEIRA GRANDE	MA
CAJAPIO	MA
CAJARI	MA
CANDIDO MENDES	MA
CANTANHEDE	MA
CARUTAPERA	MA
CEDRAL	MA
CENTRAL DO MARANHAO	MA
CENTRO DO GUILHERME	MA
CENTRO NOVO DO MARANHAO	MA
CHAPADINHA	MA
COELHO NETO	MA
CONCEICAO DO LAGO-ACU	MA
CURURUPU	MA
DUQUE BACELAR	MA
GODOFREDO VIANA	MA
GOVERNADOR NEWTON BELLO	MA
GOVERNADOR NUNES FREIRE	MA
GUIMARAES	MA
HUMBERTO DE CAMPOS	MA
ICATU	MA
IGARAPE DO MEIO	MA
ITAPECURU MIRIM	MA
JUNCO DO MARANHAO	MA
LUIS DOMINGUES	MA
MAGALHAES DE ALMEIDA	MA
MARACACUME	MA
MARAJA DO SENA	MA
MARANHAOZINHO	MA
MATA ROMA	MA
MATINHA	MA
MATOES DO NORTE	MA
MILAGRES DO MARANHAO	MA
MIRANDA DO NORTE	MA
MIRINZAL	MA
MONCAO	MA
MORROS	MA
NINA RODRIGUES	MA
NOVA OLINDA DO MARANHAO	MA
OLHO D'AGUA DAS CUNHAS	MA
OLINDA NOVA DO MARANHAO	MA
PALMEIRANDIA	MA
PAULINO NEVES	MA
PAULO RAMOS	MA
PEDRO DO ROSARIO	MA
PENALVA	MA
PERI MIRIM	MA
PINDARE-MIRIM	MA
PINHEIRO	MA
PIO XII	MA
PIRAPEMAS	MA
PORTO RICO DO MARANHAO	MA
PRESIDENTE JUSCELINO	MA
PRESIDENTE MEDICI	MA
PRESIDENTE SARNEY	MA
PRESIDENTE VARGAS	MA
PRIMEIRA CRUZ	MA
RAPOSA	MA
ROSARIO	MA
SANTA HELENA	MA
SANTA INES	MA
SANTA LUZIA	MA
SANTA LUZIA DO PARUA	MA
SANTA QUITERIA DO MARANHAO	MA
SANTA RITA	MA
SANTANA DO MARANHAO	MA
SANTO AMARO DO MARANHAO	MA
SAO BENEDITO DO RIO PRETO	MA
SAO BENTO	MA
SAO BERNARDO	MA
SAO JOAO BATISTA	MA
SAO JOAO DO CARU	MA
SAO JOSE DE RIBAMAR	MA
SAO LUIS	MA
SAO VICENTE FERRER	MA
SATUBINHA	MA
SERRANO DO MARANHAO	MA
TUFILANDIA	MA
TURIACU	MA
TURILANDIA	MA
TUTOIA	MA
URBANO SANTOS	MA
VARGEM GRANDE	MA
VIANA	MA
VITORIA DO MEARIM	MA
VITORINO FREIRE	MA
ZE DOCA	MA
DDD 99
ACAILANDIA	MA
ALDEIAS ALTAS	MA
ALTO ALEGRE DO MARANHAO	MA
ALTO PARNAIBA	MA
AMARANTE DO MARANHAO	MA
ARAME	MA
BACABAL	MA
BALSAS	MA
BARRA DO CORDA	MA
BENEDITO LEITE	MA
BERNARDO DO MEARIM	MA
BOM LUGAR	MA
BURITI BRAVO	MA
BURITIRANA	MA
CAMPESTRE DO MARANHAO	MA
CAPINZAL DO NORTE	MA
CAROLINA	MA
CAXIAS	MA
CIDELANDIA	MA
CODO	MA
COLINAS	MA
COROATA	MA
DAVINOPOLIS	MA
DOM PEDRO	MA
ESPERANTINOPOLIS	MA
ESTREITO	MA
FEIRA NOVA DO MARANHAO	MA
FERNANDO FALCAO	MA
FORMOSA DA SERRA NEGRA	MA
FORTALEZA DOS NOGUEIRAS	MA
FORTUNA	MA
GONCALVES DIAS	MA
GOVERNADOR ARCHER	MA
GOVERNADOR EDISON LOBAO	MA
GOVERNADOR EUGENIO BARROS	MA
GOVERNADOR LUIZ ROCHA	MA
GRACA ARANHA	MA
GRAJAU	MA
IGARAPE GRANDE	MA
IMPERATRIZ	MA
ITAIPAVA DO GRAJAU	MA
ITINGA DO MARANHAO	MA
JATOBA	MA
JENIPAPO DOS VIEIRAS	MA
JOAO LISBOA	MA
JOSELANDIA	MA
LAGO DA PEDRA	MA
LAGO DO JUNCO	MA
LAGO DOS RODRIGUES	MA
LAGO VERDE	MA
LAGOA DO MATO	MA
LAGOA GRANDE DO MARANHAO	MA
LAJEADO NOVO	MA
LIMA CAMPOS	MA
LORETO	MA
MATOES	MA
MIRADOR	MA
MONTES ALTOS	MA
NOVA COLINAS	MA
NOVA IORQUE	MA
PARAIBANO	MA
PARNARAMA	MA
PASSAGEM FRANCA	MA
PASTOS BONS	MA
PEDREIRAS	MA
PERITORO	MA
POCAO DE PEDRAS	MA
PORTO FRANCO	MA
PRESIDENTE DUTRA	MA
RIACHAO	MA
RIBAMAR FIQUENE	MA
SAMBAIBA	MA
SANTA FILOMENA DO MARANHAO	MA
SANTO ANTONIO DOS LOPES	MA
SAO DOMINGOS DO AZEITAO	MA
SAO DOMINGOS DO MARANHAO	MA
SAO FELIX DE BALSAS	MA
SAO FRANCISCO DO BREJAO	MA
SAO FRANCISCO DO MARANHAO	MA
SAO JOAO DO PARAISO	MA
SAO JOAO DO SOTER	MA
SAO JOAO DOS PATOS	MA
SAO JOSE DOS BASILIOS	MA
SAO LUIS GONZAGA DO MARANHAO	MA
SAO MATEUS DO MARANHAO	MA
SAO PEDRO DA AGUA BRANCA	MA
SAO PEDRO DOS CRENTES	MA
SAO RAIMUNDO DAS MANGABEIRAS	MA
SAO RAIMUNDO DO DOCA BEZERRA	MA
SAO ROBERTO	MA
SENADOR ALEXANDRE COSTA	MA
SENADOR LA ROCQUE	MA
SITIO NOVO	MA
SUCUPIRA DO NORTE	MA
SUCUPIRA DO RIACHAO	MA
TASSO FRAGOSO	MA
TIMBIRAS	MA
TIMON	MA
TRIZIDELA DO VALE	MA
TUNTUM	MA
VILA NOVA DOS MARTIRIOS	MA
